# English 100k Failures - Typing Variants
# Tests self-cancel patterns (schoool → school)
# Format: INPUT \t EXPECTED \t ACTUAL \t BUFFER
# Total: 3504
#
# INPUT: variant typed (e.g., schoool)
# EXPECTED: original English word (e.g., school)
# ACTUAL: engine output
# BUFFER: Vietnamese transform state

been	been	bên	bên
see	see	sê	sê
betweeen	between	betweeen	betwêen
how	how	hơ	hơ
now	now	nơ	nơ
own	own	ơn	ơn
threee	three	threee	thrêe
down	down	dơn	dơn
knoww	know	knoww	knơw
too	too	tô	tô
schoool	school	schoool	schôol
followwing	following	followwing	follơwing
knowwn	known	knowwn	knơwn
seen	seen	sên	sên
freee	free	freee	frêe
low	low	lơ	lơ
knowwledge	knowledge	knowwledge	knơwledge
room	room	rôm	rôm
showw	show	showw	shơw
showwn	shown	showwn	shơwn
growwth	growth	growwth	grơwth
foood	food	foood	fôod
seems	seems	sếm	sêms
bloood	blood	bloood	blôod
feeel	feel	feeel	fêel
soon	soon	sôn	sôn
midddle	middle	midddle	miđdle
indeeed	indeed	indeeed	indêed
adddition	addition	adddition	ađdition
beloww	below	beloww	belơw
committeee	committee	committeee	committêe
showws	shows	showws	shơws
poor	poor	pổ	pôr
town	town	tơn	tơn
seem	seem	sêm	sêm
followwed	followed	followwed	follơwed
door	door	dổ	dôr
degreee	degree	degreee	degrêe
streeet	street	streeet	strêet
feeet	feet	feeet	fêet
addded	added	addded	ađded
schoools	schools	schoools	schôols
floww	flow	floww	flơw
followw	follow	followw	follơw
agreeement	agreement	agreeement	agrêement
laws	laws	lắ	lăs
addditional	additional	addditional	ađditional
freeedom	freedom	freeedom	frêedom
meet	meet	mêt	mêt
greeen	green	greeen	grêen
feeeling	feeling	feeeling	fêeling
followws	follows	followws	follơws
alloww	allow	alloww	allơw
speeech	speech	speeech	spêech
allowwed	allowed	allowwed	allơwed
browwn	brown	browwn	brơwn
addd	add	addd	ađd
adddress	address	adddress	ađdress
growwing	growing	growwing	grơwing
stoood	stood	stoood	stôod
showwed	showed	showwed	shơwed
flooor	floor	flooor	flôor
tree	tree	trê	trê
windoww	window	windoww	windơw
speeed	speed	speeed	spêed
employeees	employees	employeees	employêes
agreeed	agreed	agreeed	agrêed
trees	trees	trế	três
understoood	understood	understoood	understôod
drawwn	drawn	drawwn	drăwn
woood	wood	uood	wôod
fooot	foot	fooot	fôot
choose	choose	chốe	chôse
sudddenly	suddenly	sudddenly	suđdenly
feeelings	feelings	feeelings	fêelings
sleeep	sleep	sleeep	slêep
slowwly	slowly	slowwly	slơwly
knowws	knows	knowws	knơws
showwing	showing	showwing	shơwing
steeel	steel	steeel	stêel
greeek	greek	greeek	grêek
engineeering	engineering	engineeering	enginêering
sloww	slow	sloww	slơw
windowws	windows	windowws	windơws
allowws	allows	allowws	allơws
drawwing	drawing	drawwing	drăwing
groww	grow	groww	grơw
draww	draw	draww	drăw
troops	troops	trốp	trôps
agreee	agree	agreee	agrêe
nineteeenth	nineteenth	nineteeenth	ninetêenth
queen	queen	quên	quên
knowwing	knowing	knowwing	knơwing
employeee	employee	employeee	employêe
narroww	narrow	naroww	narrơw
proceeedings	proceedings	proceeedings	procêedings
yelloww	yellow	yelloww	yellơw
unknowwn	unknown	unknowwn	unknơwn
screeen	screen	screeen	scrêen
felloww	fellow	felloww	fellơw
root	root	rôt	rôt
growwn	grown	growwn	grơwn
prooof	proof	prooof	prôof
degreees	degrees	degreees	degrêes
row	row	rơ	rơ
sheeet	sheet	sheeet	shêet
lee	lee	lê	lê
flowwers	flowers	flowwers	flơwers
rooms	rooms	rốm	rôms
coffeee	coffee	cofeee	coffêe
childhoood	childhood	childhoood	childhôod
moon	moon	môn	môn
streeets	streets	streeets	strêets
towns	towns	tớn	tơns
roots	roots	rốt	rôts
snoww	snow	snoww	snơw
fifteeen	fifteen	fifteeen	fiftêen
sees	sees	sế	sês
adddressed	addressed	adddressed	ađdressed
suddden	sudden	suddden	suđden
addding	adding	addding	ađding
hiddden	hidden	hiddden	hiđden
crowwn	crown	crowwn	crơwn
allowwing	allowing	allowwing	allơwing
smoooth	smooth	smoooth	smôoth
feeed	feed	feeed	fêed
crowwd	crowd	crowwd	crơwd
classrooom	classroom	classrooom	classrôom
somehoww	somehow	somehoww	somehơw
succeeeded	succeeded	succeeeded	succêeded
feeels	feels	feeels	fêels
eighteeenth	eighteenth	eighteeenth	eightêenth
agreeements	agreements	agreeements	agrêements
doors	doors	dố	dôrs
shoook	shook	shoook	shôok
flowws	flows	flowws	flơws
roof	roof	rồ	rôf
proceeed	proceed	proceeed	procêed
feeeding	feeding	feeeding	fêeding
fooods	foods	fooods	fôods
tomorroww	tomorrow	tomorroww	tomorrơw
shadoww	shadow	shadoww	shadơw
loose	loose	lốe	lôse
loop	loop	lôp	lôp
feeedback	feedback	feeedback	fêedback
throww	throw	throww	thrơw
woooden	wooden	uooden	wôoden
noddded	nodded	noddded	nođded
feee	fee	feee	fêe
wooods	woods	uoods	wôods
feees	fees	feees	fêes
engineeers	engineers	engineeers	enginêers
sheeep	sheep	sheeep	shêep
creeek	creek	creeek	crêek
bloww	blow	bloww	blơw
flowwer	flower	flowwer	flơwer
neighborhoood	neighborhood	neighborhoood	neighborhôod
throwwn	thrown	throwwn	thrơwn
committeees	committees	committeees	committêes
oddd	odd	oddd	ođd
freeely	freely	freeely	frêely
fleeet	fleet	fleeet	flêet
thee	thee	thê	thê
moore	moore	mổe	môre
engineeer	engineer	engineeer	enginêer
greeece	greece	greeece	grêece
beer	beer	bể	bêr
succeeed	succeed	succeeed	succêed
sleeeping	sleeping	sleeeping	slêeping
addds	adds	addds	ađds
adddresses	addresses	adddresses	ađdresses
proceeeds	proceeds	proceeeds	procêeds
acknowwledged	acknowledged	acknowwledged	acknơwledged
sheeets	sheets	sheeets	shêets
withdrawwal	withdrawal	withdrawwal	withdrăwal
keeps	keeps	kếp	kêps
floood	flood	floood	flôod
handboook	handbook	handboook	handbôok
followwers	followers	followwers	follơwers
seventeeenth	seventeenth	seventeeenth	seventêenth
dawn	dawn	dăn	dăn
kneees	knees	kneees	knêes
eighteeen	eighteen	eighteeen	eightêen
acknowwledge	acknowledge	acknowwledge	acknơwledge
drawwings	drawings	drawwings	drăwings
fourteeen	fourteen	fourteeen	fourtêen
bedrooom	bedroom	bedrooom	bedrôom
growws	grows	growws	grơws
bow	bow	bơ	bơ
kneee	knee	kneee	knêe
rows	rows	rớ	rơs
likelihoood	likelihood	likelihoood	likelihôod
proceeeded	proceeded	proceeeded	procêeded
bleeeding	bleeding	bleeeding	blêeding
shalloww	shallow	shalloww	shallơw
outloook	outlook	outloook	outlôok
breeeding	breeding	breeeding	brêeding
arroww	arrow	aroww	arrơw
shooot	shoot	shooot	shôot
proceeeding	proceeding	proceeeding	procêeding
shoooting	shooting	shoooting	shôoting
screeening	screening	screeening	scrêening
peer	peer	pể	pêr
foootball	football	foootball	fôotball
breakdowwn	breakdown	breakdowwn	breakdơwn
speeeches	speeches	speeeches	spêeches
foool	fool	foool	fôol
flowwing	flowing	flowwing	flơwing
shadowws	shadows	shadowws	shadơws
tennesseee	tennessee	tennesseee	tennessêe
embeddded	embedded	embeddded	embeđded
budddhist	buddhist	budddhist	buđdhist
meets	meets	mết	mêts
decreee	decree	decreee	decrêe
volunteeers	volunteers	volunteeers	voluntêers
drawws	draws	drawws	drăws
crowwded	crowded	crowwded	crơwded
deer	deer	dể	dêr
widoww	widow	widoww	widơw
adddressing	addressing	adddressing	ađdressing
budddha	buddha	budddha	buđdha
woool	wool	uool	wôol
cow	cow	cơ	cơ
blooody	bloody	blooody	blôody
hollywoood	hollywood	hollywoood	hollywôod
peers	peers	pế	pêrs
deeds	deeds	đế	dêds
greeeks	greeks	greeeks	grêeks
allowwance	allowance	allowwance	allơwance
forbiddden	forbidden	forbiddden	forbiđden
borrowwed	borrowed	borowwed	borrơwed
shaww	shaw	shaww	shăw
steeep	steep	steeep	stêep
throwwing	throwing	throwwing	thrơwing
holloww	hollow	holloww	hollơw
deed	deed	đê	dêd
keen	keen	kên	kên
beef	beef	bề	bêf
godddess	goddess	godddess	gođdess
bladdder	bladder	bladdder	blađder
withdraww	withdraw	withdraww	withdrăw
sheeer	sheer	sheeer	shêer
sorroww	sorrow	soroww	sorrơw
noon	noon	nôn	nôn
boots	boots	bốt	bôts
volunteeer	volunteer	volunteeer	voluntêer
oddds	odds	oddds	ođds
seventeeen	seventeen	seventeeen	seventêen
schoooling	schooling	schoooling	schôoling
budddhism	buddhism	budddhism	buđdhism
boom	boom	bôm	bôm
withdrawwn	withdrawn	withdrawwn	withdrăwn
pioneeer	pioneer	pioneeer	pionêer
mcgraww	mcgraw	mcgraww	mcgrăw
arrowws	arrows	arowws	arrơws
bathrooom	bathroom	bathrooom	bathrôom
fourteeenth	fourteenth	fourteeenth	fourtêenth
fooolish	foolish	fooolish	fôolish
freeed	freed	freeed	frêed
aa	aa	â	â
straww	straw	straww	străw
borrowwing	borrowing	borowwing	borrơwing
agreees	agrees	agreees	agrêes
outdooor	outdoor	outdooor	outdôor
cows	cows	cớ	cơs
addditionally	additionally	addditionally	ađditionally
eisenhowwer	eisenhower	eisenhowwer	eisenhơwer
blooom	bloom	blooom	blôom
dowwntowwn	downtown	downtowwn	dơwntơwn
laddder	ladder	laddder	lađder
fellowws	fellows	fellowws	fellơws
fellowwship	fellowship	fellowwship	fellơwship
slowwer	slower	slowwer	slơwer
manpowwer	manpower	manpowwer	manpơwer
fifteeenth	fifteenth	fifteeenth	fiftêenth
overloooked	overlooked	overloooked	overlôoked
showwer	shower	showwer	shơwer
doorway	doorway	dơảy	dôrway
breeed	breed	breeed	brêed
flooors	floors	flooors	flôors
jaww	jaw	jaww	jăw
blowwn	blown	blowwn	blơwn
sadddle	saddle	sadddle	sađdle
marroww	marrow	maroww	marrơw
broooks	brooks	broooks	brôoks
freeezing	freezing	freeezing	frêezing
elboww	elbow	elboww	elbơw
unawware	unaware	unawware	unăware
nineteeen	nineteen	nineteeen	ninetêen
freeeman	freeman	freeeman	frêeman
speeeds	speeds	speeeds	spêeds
borroww	borrow	boroww	borrơw
greeeted	greeted	greeeted	grêeted
addditions	additions	addditions	ađditions
blowwing	blowing	blowwing	blơwing
gloww	glow	gloww	glơw
crowwds	crowds	crowwds	crơwds
succeeeding	succeeding	succeeeding	succêeding
breeeze	breeze	breeeze	brêeze
lawn	lawn	lăn	lăn
delawware	delaware	delawware	delăware
chooses	chooses	chốe	chôses
warsaww	warsaw	warsaww	warsăw
teaspooon	teaspoon	teaspooon	teaspôon
glasgoww	glasgow	glasgoww	glasgơw
freeeze	freeze	freeeze	frêeze
morroww	morrow	moroww	morrơw
ottawwa	ottawa	ottawwa	ottăwa
bee	bee	bê	bê
steeering	steering	steeering	stêering
endowwed	endowed	endowwed	endơwed
poorer	poorer	pổe	pôrer
broooklyn	brooklyn	broooklyn	brôoklyn
boot	boot	bôt	bôt
swallowwed	swallowed	swallowwed	swallơwed
allowwances	allowances	allowwances	allơwances
liverpoool	liverpool	liverpoool	liverpôol
neighbourhoood	neighbourhood	neighbourhoood	neighbourhôod
greeene	greene	greeene	grêene
neighborhooods	neighborhoods	neighborhooods	neighborhôods
loops	loops	lốp	lôps
ballooon	balloon	ballooon	ballôon
flowwering	flowering	flowwering	flơwering
blowws	blows	blowws	blơws
creeed	creed	creeed	crêed
smooothly	smoothly	smooothly	smôothly
adddiction	addiction	adddiction	ađdiction
owns	owns	ớn	ơns
foootnote	footnote	foootnote	fôotnote
classroooms	classrooms	classroooms	classrôoms
microwwave	microwave	microwwave	micrơwave
croww	crow	croww	crơw
swalloww	swallow	swalloww	swallơw
undertoook	undertook	undertoook	undertôok
bees	bees	bế	bês
tablespooons	tablespoons	tablespooons	tablespôons
throwws	throws	throwws	thrơws
browwser	browser	browwser	brơwser
creeep	creep	creeep	crêep
screeens	screens	screeens	scrêens
brotherhoood	brotherhood	brotherhoood	brotherhôod
pilloww	pillow	pilloww	pillơw
noteboook	notebook	noteboook	notebôok
reef	reef	rề	rêf
broww	brow	broww	brơw
adulthoood	adulthood	adulthoood	adulthôod
pioneeers	pioneers	pioneeers	pionêers
acknowwledgments	acknowledgments	acknowwledgments	acknơwledgments
slowwed	slowed	slowwed	slơwed
agreeeable	agreeable	agreeeable	agrêeable
gown	gown	gơn	gơn
prooofs	proofs	prooofs	prôofs
englewoood	englewood	englewoood	englewôod
edddie	eddie	edddie	eđdie
flowwed	flowed	flowwed	flơwed
overthroww	overthrow	overthroww	overthrơw
drawwer	drawer	drawwer	drăwer
unlawwful	unlawful	unlawwful	unlăwful
rainboww	rainbow	rainboww	rainbơw
broook	brook	broook	brôok
toddd	todd	toddd	tođd
crawwford	crawford	crawwford	crăwford
stoool	stool	stoool	stôol
hawk	hawk	hăk	hăk
greeeting	greeting	greeeting	grêeting
foootsteps	footsteps	foootsteps	fôotsteps
landowwners	landowners	landowwners	landơwners
squeeezed	squeezed	squeeezed	squêezed
spooon	spoon	spooon	spôon
microoorganisms	microorganisms	microoorganisms	micrôorganisms
frowwned	frowned	frowwned	frơwned
bambooo	bamboo	bambooo	bambôo
glowwing	glowing	glowwing	glơwing
meadoww	meadow	meadoww	meadơw
milwaukeee	milwaukee	milwaukeee	milwaukêe
troop	troop	trôp	trôp
adddison	addison	adddison	ađdison
drowwned	drowned	drowwned	drơwned
spleeen	spleen	spleeen	splêen
greeenhouse	greenhouse	greeenhouse	grêenhouse
narrowwly	narrowly	narowwly	narrơwly
greeed	greed	greeed	grêed
squeeeze	squeeze	squeeeze	squêeze
queer	queer	quể	quêr
acknowwledgment	acknowledgment	acknowwledgment	acknơwledgment
feeeble	feeble	feeeble	fêeble
empowwered	empowered	empowwered	empơwered
boost	boost	bốt	bôst
feeeds	feeds	feeeds	fêeds
oo	oo	ô	ô
sleeeve	sleeve	sleeeve	slêeve
teen	teen	tên	tên
endowwment	endowment	endowwment	endơwment
teens	teens	tến	têns
subcommitteee	subcommittee	subcommitteee	subcommittêe
fleee	flee	fleee	flêe
roofs	roofs	rố	rôfs
flooods	floods	flooods	flôods
acknowwledges	acknowledges	acknowwledges	acknơwledges
biddding	bidding	biddding	biđding
knowwledgeable	knowledgeable	knowwledgeable	knơwledgeable
yearboook	yearbook	yearboook	yearbôok
renowwned	renowned	renowwned	renơwned
browwning	browning	browwning	brơwning
preschoool	preschool	preschoool	preschôol
foooting	footing	foooting	fôoting
eyebrowws	eyebrows	eyebrowws	eyebrơws
acknowwledging	acknowledging	acknowwledging	acknơwledging
crowwned	crowned	crowwned	crơwned
shooots	shoots	shooots	shôots
eec	eec	êc	êc
floooded	flooded	floooded	flôoded
addditive	additive	addditive	ađditive
floooding	flooding	floooding	flôoding
overloooking	overlooking	overloooking	overlôoking
kuwwait	kuwait	kuwwait	kưwait
narrowwed	narrowed	narowwed	narrơwed
empowwerment	empowerment	empowwerment	empơwerment
livelihoood	livelihood	livelihoood	livelihôod
goose	goose	gốe	gôse
meadowws	meadows	meadowws	meadơws
narrowwer	narrower	narowwer	narrơwer
allowwable	allowable	allowwable	allơwable
freeedoms	freedoms	freeedoms	frêedoms
wooodland	woodland	uoodland	wôodland
overloook	overlook	overloook	overlôok
agreeeing	agreeing	agreeeing	agrêeing
greeet	greet	greeet	grêet
glooomy	gloomy	glooomy	glôomy
yankeee	yankee	yankeee	yankêe
grooove	groove	grooove	grôove
indooor	indoor	indooor	indôor
acknowwledgements	acknowledgements	acknowwledgements	acknơwledgements
widowws	widows	widowws	widơws
budddy	buddy	budddy	buđdy
pioneeering	pioneering	pioneeering	pionêering
flowwn	flown	flowwn	flơwn
jawws	jaws	jawws	jăws
bestowwed	bestowed	bestowwed	bestơwed
decreees	decrees	decreees	decrêes
edddy	eddy	edddy	eđdy
cheer	cheer	chể	chêr
mudddy	muddy	mudddy	muđdy
manhoood	manhood	manhoood	manhôod
zooo	zoo	zooo	zôo
queens	queens	quến	quêns
downs	downs	dớn	dơns
willoww	willow	willoww	willơw
growwers	growers	growwers	grơwers
kathleeen	kathleen	kathleeen	kathlêen
greeenwoood	greenwood	greeenwoood	grêenwôod
borrowwer	borrower	borowwer	borrơwer
glooom	gloom	glooom	glôom
poorest	poorest	pôét	pôrest
breeeds	breeds	breeeds	brêeds
greeens	greens	greeens	grêens
priesthoood	priesthood	priesthoood	priesthôod
motherhoood	motherhood	motherhoood	motherhôod
padddy	paddy	padddy	pađdy
grooom	groom	grooom	grôom
foools	fools	foools	fôols
riddden	ridden	riddden	riđden
succeeeds	succeeds	succeeeds	succêeds
redddish	reddish	redddish	ređdish
courtrooom	courtroom	courtrooom	courtrôom
blooomington	bloomington	blooomington	blôomington
tablespooon	tablespoon	tablespooon	tablespôon
fowwler	fowler	fowwler	fơwler
narrowwing	narrowing	narowwing	narrơwing
doom	doom	dôm	dôm
ee	ee	ê	ê
sleeeves	sleeves	sleeeves	slêeves
wooody	woody	uoody	wôody
slowwing	slowing	slowwing	slơwing
steeer	steer	steeer	stêer
volunteeered	volunteered	volunteeered	voluntêered
odddly	oddly	odddly	ođdly
dow	dow	dơ	dơ
vow	vow	vơ	vơ
broooke	brooke	broooke	brôoke
outdooors	outdoors	outdooors	outdôors
browwne	browne	browwne	brơwne
anyhoww	anyhow	anyhoww	anyhơw
outfloww	outflow	outfloww	outflơw
bows	bows	bớ	bơs
crawwl	crawl	crawwl	crăwl
steeele	steele	steeele	stêele
flawws	flaws	flawws	flăws
screeened	screened	screeened	scrêened
steeels	steels	steeels	stêels
sown	sown	sơn	sơn
greeenland	greenland	greeenland	grêenland
greeenwich	greenwich	greeenwich	grêenwich
swallowwing	swallowing	swallowwing	swallơwing
followwer	follower	followwer	follơwer
creeeping	creeping	creeeping	crêeping
dee	dee	dê	dê
vows	vows	vớ	vơs
wooolf	woolf	uoolf	wôolf
tedddy	teddy	tedddy	teđdy
tabooo	taboo	tabooo	tabôo
speeedy	speedy	speeedy	spêedy
elbowws	elbows	elbowws	elbơws
crawwled	crawled	crawwled	crăwled
foootnotes	footnotes	foootnotes	fôotnotes
fleeeing	fleeing	fleeeing	flêeing
withdrawwing	withdrawing	withdrawwing	withdrăwing
acknowwledgement	acknowledgement	acknowwledgement	acknơwledgement
overfloww	overflow	overfloww	overflơw
yidddish	yiddish	yidddish	yiđdish
beddding	bedding	beddding	beđding
infloww	inflow	infloww	inflơw
croooked	crooked	croooked	crôoked
rupeees	rupees	rupeees	rupêes
wooodward	woodward	uoodward	wôodward
greeedy	greedy	greeedy	grêedy
drowwning	drowning	drowwning	drơwning
sleeepy	sleepy	sleeepy	slêepy
spreadsheeet	spreadsheet	spreadsheeet	spreadshêet
kneeeling	kneeling	kneeeling	knêeling
greeenberg	greenberg	greeenberg	grêenberg
sadddam	saddam	sadddam	sađdam
showwers	showers	showwers	shơwers
salooon	saloon	salooon	salôon
crawwling	crawling	crawwling	crăwling
fooodstuffs	foodstuffs	fooodstuffs	fôodstuffs
sow	sow	sơ	sơ
fleeeting	fleeting	fleeeting	flêeting
drawwers	drawers	drawwers	drăwers
crowwns	crowns	crowwns	crơwns
lesseee	lessee	leseee	lessêe
traineees	trainees	traineees	trainêes
bedroooms	bedrooms	bedroooms	bedrôoms
loom	loom	lôm	lôm
ooo	ooo	oo	ôo
engineeered	engineered	engineeered	enginêered
redeeemed	redeemed	redeeemed	redêemed
platooon	platoon	platooon	platôon
smooothing	smoothing	smooothing	smôothing
foreseeen	foreseen	foreseeen	foresêen
forbiddding	forbidding	forbiddding	forbiđding
aberdeeen	aberdeen	aberdeeen	aberdêen
woooded	wooded	uooded	wôoded
noddding	nodding	noddding	nođding
smooothed	smoothed	smooothed	smôothed
clawws	claws	clawws	clăws
crowwding	crowding	crowwding	crơwding
jeeep	jeep	jeeep	jêep
addditives	additives	addditives	ađditives
flaww	flaw	flaww	flăw
ridddle	riddle	ridddle	riđdle
decreeed	decreed	decreeed	decrêed
tow	tow	tơ	tơ
dd	dd	đ	đ
reefs	reefs	rế	rêfs
freeeing	freeing	freeeing	frêeing
lagooon	lagoon	lagooon	lagôon
greeetings	greetings	greeetings	grêetings
geeese	geese	geeese	gêese
yellowwish	yellowish	yellowwish	yellơwish
tee	tee	tê	tê
drawwbacks	drawbacks	drawwbacks	drăwbacks
yankeees	yankees	yankeees	yankêes
flawwed	flawed	flawwed	flăwed
shadowwy	shadowy	shadowwy	shadơwy
borrowwers	borrowers	borowwers	borrơwers
georgetowwn	georgetown	georgetowwn	georgetơwn
plywoood	plywood	plywoood	plywôod
indooors	indoors	indooors	indôors
seafoood	seafood	seafoood	seafôod
moor	moor	mổ	môr
deem	deem	dêm	dêm
wooodroww	woodrow	uoodroww	wôodrơw
newsweeek	newsweek	newsweeek	newswêek
housekeeeping	housekeeping	housekeeeping	housekêeping
midddleton	middleton	midddleton	miđdleton
alooof	aloof	alooof	alôof
drawwback	drawback	drawwback	drăwback
foreseeeable	foreseeable	foreseeeable	foresêeable
frowwn	frown	frowwn	frơwn
sorrowws	sorrows	sorowws	sorrơws
foddder	fodder	foddder	fođder
landowwner	landowner	landowwner	landơwner
widowwed	widowed	widowwed	widơwed
evergreeen	evergreen	evergreeen	evergrêen
knowwingly	knowingly	knowwingly	knơwingly
falsehoood	falsehood	falsehoood	falsehôod
woww	wow	woww	wơw
runawway	runaway	runawway	runăway
adddicts	addicts	adddicts	ađdicts
noteboooks	notebooks	noteboooks	notebôoks
foreseee	foresee	foreseee	foresêe
feeeder	feeder	feeeder	fêeder
barroww	barrow	baroww	barrơw
broood	brood	broood	brôod
devoteees	devotees	devoteees	devotêes
sparroww	sparrow	sparroww	sparrơw
middday	midday	middday	miđday
clowwn	clown	clowwn	clơwn
redeeem	redeem	redeeem	redêem
pillowws	pillows	pillowws	pillơws
licenseee	licensee	licenseee	licensêe
sheddding	shedding	sheddding	sheđding
speeeding	speeding	speeeding	spêeding
gaas	gaas	gấ	gâs
housekeeeper	housekeeper	housekeeeper	housekêeper
puddding	pudding	puddding	puđding
monsooon	monsoon	mónoon	monsôon
monsoon	monsoon	mónon	monsôn
browwse	browse	browwse	brơwse
boon	boon	bôn	bôn
padddle	paddle	padddle	pađdle
moose	moose	mốe	môse
brooom	broom	brooom	brôom
ploww	plow	ploww	plơw
jubileee	jubilee	jubileee	jubilêe
grassrooots	grassroots	grassrooots	grassrôots
zooom	zoom	zooom	zôom
kluwwer	kluwer	kluwwer	klưwer
hudddled	huddled	hudddled	huđdled
strawwberry	strawberry	strawwberry	străwberry
budddhists	buddhists	budddhists	buđdhists
boyhoood	boyhood	boyhoood	boyhôod
prowwess	prowess	prowwess	prơwess
adddicted	addicted	adddicted	ađdicted
freeer	freer	freeer	frêer
een	een	ên	ên
fowwl	fowl	fowwl	fơwl
croook	crook	croook	crôok
cheers	cheers	chế	chêrs
speeedily	speedily	speeedily	spêedily
galileee	galilee	galileee	galilêe
groooves	grooves	groooves	grôoves
dodd	dodd	dod	dođ
bleeed	bleed	bleeed	blêed
honeymooon	honeymoon	honeymooon	honeymôon
drowwn	drown	drowwn	drơwn
nee	nee	nê	nê
stoools	stools	stoools	stôols
browws	brows	browws	brơws
barloww	barlow	barloww	barlơw
aaa	aaa	aa	âa
firewoood	firewood	firewoood	firewôod
godddesses	goddesses	godddesses	gođdesses
freeedman	freedman	freeedman	frêedman
looms	looms	lốm	lôms
broookings	brookings	broookings	brôokings
growwled	growled	growwled	grơwled
moors	moors	mố	môrs
bridegrooom	bridegroom	bridegrooom	bridegrôom
kiddding	kidding	kiddding	kiđding
loosen	loosen	lôén	lôsen
beech	beech	bêch	bêch
blooodshed	bloodshed	blooodshed	blôodshed
hawks	hawks	hắk	hăks
sleeeps	sleeps	sleeeps	slêeps
pioneeered	pioneered	pioneeered	pionêered
broooding	brooding	broooding	brôoding
bestoww	bestow	bestoww	bestơw
foootage	footage	foootage	fôotage
threeefold	threefold	threeefold	thrêefold
outlaww	outlaw	outlaww	outlăw
horsepowwer	horsepower	horsepowwer	horsepơwer
geee	gee	geee	gêe
preeexisting	preexisting	preeexisting	prêexisting
beet	beet	bêt	bêt
zooology	zoology	zooology	zôology
snowwy	snowy	snowwy	snơwy
malawwi	malawi	malawwi	malăwi
spawwning	spawning	spawwning	spăwning
zoool	zool	zoool	zôol
squeeezing	squeezing	squeeezing	squêezing
grandddaughter	granddaughter	grandddaughter	granđdaughter
endowwments	endowments	endowwments	endơwments
eileeen	eileen	eileeen	eilêen
marlowwe	marlowe	marlowwe	marlơwe
ballooons	balloons	ballooons	ballôons
sherwoood	sherwood	sherwoood	sherwôod
ddt	ddt	đt	đt
buddding	budding	buddding	buđding
shudddered	shuddered	shudddered	shuđdered
burrowws	burrows	burowws	burrơws
bloooms	blooms	bloooms	blôoms
fleeets	fleets	fleeets	flêets
overseee	oversee	overseee	oversêe
teaspooons	teaspoons	teaspooons	teaspôons
greeenish	greenish	greeenish	grêenish
troubleshoooting	troubleshooting	troubleshoooting	troubleshôoting
nomineee	nominee	nomineee	nominêe
claww	claw	claww	clăw
overthrowwn	overthrown	overthrowwn	overthrơwn
schoooner	schooner	schoooner	schôoner
empowwering	empowering	empowwering	empơwering
bloooded	blooded	bloooded	blôoded
camerooon	cameroon	camerooon	camerôon
adddict	addict	adddict	ađdict
strawwberries	strawberries	strawwberries	străwberries
embeddding	embedding	embeddding	embeđding
creeeks	creeks	creeeks	crêeks
avowwed	avowed	avowwed	avơwed
overshadowwed	overshadowed	overshadowwed	overshadơwed
shuddder	shudder	shuddder	shuđder
paddded	padded	paddded	pađded
gallbladdder	gallbladder	gallbladdder	gallblađder
overflowwing	overflowing	overflowwing	overflơwing
lawns	lawns	lắn	lăns
steeered	steered	steeered	stêered
beers	beers	bế	bêrs
biddder	bidder	biddder	biđder
eyebroww	eyebrow	eyebroww	eyebrơw
hometowwn	hometown	hometowwn	hometơwn
shawwl	shawl	shawwl	shăwl
traineee	trainee	traineee	trainêe
todddler	toddler	todddler	tođdler
midddlesex	middlesex	midddlesex	miđdlesex
rees	rees	rế	rês
yellowwstone	yellowstone	yellowwstone	yellơwstone
fooothills	foothills	fooothills	fôothills
scooop	scoop	scooop	scôop
freeezer	freezer	freeezer	frêezer
gunpowwder	gunpowder	gunpowwder	gunpơwder
veneer	veneer	vener	venêr
slowws	slows	slowws	slơws
bloooming	blooming	bloooming	blôoming
breeeders	breeders	breeeders	brêeders
falloww	fallow	falloww	fallơw
empowwer	empower	empowwer	empơwer
tabooos	taboos	tabooos	tabôos
crowws	crows	crowws	crơws
pedigreee	pedigree	pedigreee	pedigrêe
steeeply	steeply	steeeply	stêeply
canaan	canaan	canan	canân
blooodstream	bloodstream	blooodstream	blôodstream
sprawwling	sprawling	sprawwling	sprăwling
statehoood	statehood	statehoood	statehôod
frowwning	frowning	frowwning	frơwning
voor	voor	vổ	vôr
outgrowwth	outgrowth	outgrowwth	outgrơwth
fellowwships	fellowships	fellowwships	fellơwships
haas	haas	hấ	hâs
browwsing	browsing	browwsing	brơwsing
groooming	grooming	groooming	grôoming
glowwed	glowed	glowwed	glơwed
godddard	goddard	godddard	gođdard
breastfeeeding	breastfeeding	breastfeeeding	breastfêeding
inflowws	inflows	inflowws	inflơws
reindeeer	reindeer	reindeeer	reindêer
spawwned	spawned	spawwned	spăwned
seer	seer	sể	sêr
bellowws	bellows	bellowws	bellơws
foootwear	footwear	foootwear	fôotwear
schooolmaster	schoolmaster	schooolmaster	schôolmaster
fidddle	fiddle	fidddle	fiđdle
godddamn	goddamn	godddamn	gođdamn
museee	musee	múee	musêe
musee	musee	múee	musê
screeenplay	screenplay	screeenplay	scrêenplay
mcdowwell	mcdowell	mcdowwell	mcdơwell
ruddder	rudder	ruddder	ruđder
ballrooom	ballroom	ballrooom	ballrôom
foootprints	footprints	foootprints	fôotprints
devoteee	devotee	devoteee	devotêe
freeedmen	freedmen	freeedmen	frêedmen
wooo	woo	uoo	wôo
woo	woo	uô	wô
overcrowwded	overcrowded	overcrowwded	overcrơwded
bazaaar	bazaar	bazaaar	bazâar
foooled	fooled	foooled	fôoled
browwnish	brownish	browwnish	brơwnish
wooodlands	woodlands	uoodlands	wôodlands
chow	chow	chơ	chơ
sunflowwer	sunflower	sunflowwer	sunflơwer
intervieweees	interviewees	intervieweees	interviewêes
harloww	harlow	harloww	harlơw
browwsers	browsers	browwsers	brơwsers
wooollen	woollen	uoollen	wôollen
flowwered	flowered	flowwered	flơwered
freeeway	freeway	freeeway	frêeway
hoop	hoop	hôp	hôp
gowns	gowns	gớn	gơns
steeeped	steeped	steeeped	stêeped
fredddie	freddie	fredddie	fređdie
breeeder	breeder	breeeder	brêeder
jawwaharlal	jawaharlal	jawwaharlal	jăwaharlal
deems	deems	dếm	dêms
sleeek	sleek	sleeek	slêek
stowwe	stowe	stowwe	stơwe
borrowwings	borrowings	borowwings	borrơwings
soot	soot	sôt	sôt
freeelance	freelance	freeelance	frêelance
foooted	footed	foooted	fôoted
rowan	rowan	rơan	rơan
workfloww	workflow	workfloww	workflơw
creeeds	creeds	creeeds	crêeds
lucknoww	lucknow	lucknoww	lucknơw
redeeemer	redeemer	redeeemer	redêemer
greeeley	greeley	greeeley	grêeley
overgrowwn	overgrown	overgrowwn	overgrơwn
withdrawwals	withdrawals	withdrawwals	withdrăwals
moons	moons	mốn	môns
masloww	maslow	masloww	maslơw
todddlers	toddlers	todddlers	tođdlers
fooothold	foothold	fooothold	fôothold
kneeel	kneel	kneeel	knêel
overseeer	overseer	overseeer	oversêer
studdded	studded	studdded	stuđded
foresaww	foresaw	foresaww	foresăw
crowwning	crowning	crowwning	crơwning
laddders	ladders	laddders	lađders
outlawwed	outlawed	outlawwed	outlăwed
renowwn	renown	renowwn	renơwn
stoooped	stooped	stoooped	stôoped
genteeel	genteel	genteeel	gentêel
breeeches	breeches	breeeches	brêeches
boookkeeeping	bookkeeping	bookkeeeping	bôokkêeping
burroww	burrow	buroww	burrơw
chimpanzeees	chimpanzees	chimpanzeees	chimpanzêes
adddictive	addictive	adddictive	ađdictive
redwoood	redwood	redwoood	redwôod
absenteeeism	absenteeism	absenteeeism	absentêeism
underwoood	underwood	underwoood	underwôod
shreddded	shredded	shreddded	shređded
bathroooms	bathrooms	bathroooms	bathrôoms
greeenfield	greenfield	greeenfield	grêenfield
zooological	zoological	zooological	zôological
wellknowwn	wellknown	wellknowwn	wellknơwn
swallowws	swallows	swallowws	swallơws
bibliobazaaar	bibliobazaar	bibliobazaaar	bibliobazâar
bungaloww	bungalow	bungaloww	bungalơw
juddd	judd	juddd	juđd
overpowwering	overpowering	overpowwering	overpơwering
redddy	reddy	redddy	ređdy
fooolishness	foolishness	fooolishness	fôolishness
shopkeeepers	shopkeepers	shopkeeepers	shopkêepers
addduced	adduced	addduced	ađduced
cowan	cowan	cơan	cơan
spooons	spoons	spooons	spôons
hee	hee	hê	hê
stooop	stoop	stooop	stôop
winsloww	winslow	winsloww	winslơw
shadowwed	shadowed	shadowwed	shadơwed
feeeders	feeders	feeeders	fêeders
wooolen	woolen	uoolen	wôolen
speeechless	speechless	speeechless	spêechless
handboooks	handbooks	handboooks	handbôoks
homeowwners	homeowners	homeowwners	homeơwners
unknowwns	unknowns	unknowwns	unknơwns
narrowws	narrows	narowws	narrơws
overcrowwding	overcrowding	overcrowwding	overcrơwding
steeeper	steeper	steeeper	stêeper
knowwles	knowles	knowwles	knơwles
okinawwa	okinawa	okinawwa	okinăwa
seawweeed	seaweed	seaweeed	seăwêed
greeer	greer	greeer	grêer
fooote	foote	fooote	fôote
gallowws	gallows	gallowws	gallơws
superpowwer	superpower	superpowwer	superpơwer
gleee	glee	gleee	glêe
showwered	showered	showwered	shơwered
floooring	flooring	floooring	flôoring
budddies	buddies	budddies	buđdies
willowws	willows	willowws	willơws
salaaam	salaam	salaaam	salâam
absenteee	absentee	absenteee	absentêe
overloooks	overlooks	overloooks	overlôoks
sheeen	sheen	sheeen	shêen
superpowwers	superpowers	superpowwers	superpơwers
adddis	addis	adddis	ađdis
adddresseee	addressee	adddresseee	ađdressêe
mcgeee	mcgee	mcgeee	mcgêe
pow	pow	pơ	pơ
loo	loo	lô	lô
redeeeming	redeeming	redeeeming	redêeming
faaa	faa	faaa	fâa
longfelloww	longfellow	longfelloww	longfellơw
smooother	smoother	smooother	smôother
loot	loot	lôt	lôt
droooping	drooping	droooping	drôoping
tokugawwa	tokugawa	tokugawwa	tokugăwa
schooolboy	schoolboy	schooolboy	schôolboy
paddding	padding	paddding	pađding
browwns	browns	browwns	brơwns
slowwness	slowness	slowwness	slơwness
furroww	furrow	furroww	furrơw
melloww	mellow	melloww	mellơw
drowwsiness	drowsiness	drowwsiness	drơwsiness
canteeen	canteen	canteeen	cantêen
hollowway	holloway	hollowway	hollơway
growwer	grower	growwer	grơwer
sorrowwful	sorrowful	sorowwful	sorrơwful
chinatowwn	chinatown	chinatowwn	chinatơwn
sarawwak	sarawak	sảwak	sarăwak
scoooped	scooped	scoooped	scôoped
nomineees	nominees	nomineees	nominêes
boo	boo	bô	bô
doorways	doorways	dơáy	dôrways
moot	moot	môt	môt
intervieweee	interviewee	intervieweee	interviewêe
gallowway	galloway	gallowway	gallơway
crowwley	crowley	crowwley	crơwley
pawn	pawn	păn	păn
freees	frees	freees	frêes
breakdowwns	breakdowns	breakdowwns	breakdơwns
plowwing	plowing	plowwing	plơwing
kangarooo	kangaroo	kangarooo	kangarôo
tattooo	tattoo	tattooo	tattôo
ridddles	riddles	ridddles	riđdles
smooothness	smoothness	smooothness	smôothness
bylawws	bylaws	bylawws	bylăws
outlawws	outlaws	outlawws	outlăws
mohawwk	mohawk	mohawwk	mohăwk
fawwcett	fawcett	fawwcett	făwcett
ow	ow	ơ	ơ
sprawwled	sprawled	sprawwled	sprăwled
biofeeedback	biofeedback	biofeeedback	biofêedback
gidddens	giddens	gidddens	giđdens
lockwoood	lockwood	lockwoood	lockwôod
renee	renee	rene	renê
hallowweeen	halloween	hallowweeen	hallơwêen
borrowws	borrows	borowws	borrơws
budddhas	buddhas	budddhas	buđdhas
shutdowwn	shutdown	shutdowwn	shutdơwn
bradshaww	bradshaw	bradshaww	bradshăw
chimpanzeee	chimpanzee	chimpanzeee	chimpanzêe
airfloww	airflow	airfloww	airflơw
hoof	hoof	hồ	hôf
lockheeed	lockheed	lockheeed	lockhêed
schooolchildren	schoolchildren	schooolchildren	schôolchildren
beddded	bedded	beddded	beđded
escroww	escrow	escroww	escrơw
fleeece	fleece	fleeece	flêece
flowwchart	flowchart	flowwchart	flơwchart
beets	beets	bết	bêts
midddlemen	middlemen	midddlemen	miđdlemen
hallowwed	hallowed	hallowwed	hallơwed
snowws	snows	snowws	snơws
spawwn	spawn	spawwn	spăwn
sleeepless	sleepless	sleeepless	slêepless
chattanoooga	chattanooga	chattanoooga	chattanôoga
norwoood	norwood	nỏood	norwôod
norwood	norwood	nỏod	norwôd
plowwed	plowed	plowwed	plơwed
withdrawws	withdraws	withdrawws	withdrăws
growwths	growths	growwths	grơwths
rupeee	rupee	rupeee	rupêe
blooomfield	bloomfield	blooomfield	blôomfield
breeech	breech	breeech	brêech
selfhoood	selfhood	selfhoood	selfhôod
sleeeper	sleeper	sleeeper	slêeper
sadddled	saddled	sadddled	sađdled
onloookers	onlookers	onloookers	onlôokers
leech	leech	lêch	lêch
breeezes	breezes	breeezes	brêezes
blackwoood	blackwood	blackwoood	blackwôod
assigneee	assignee	asigneee	assignêe
appointeees	appointees	appointeees	appointêes
fooolishly	foolishly	fooolishly	fôolishly
lees	lees	lế	lês
rudddy	ruddy	rudddy	ruđdy
toynbeee	toynbee	toynbeee	toynbêe
pee	pee	pê	pê
nationhoood	nationhood	nationhoood	nationhôod
hollowws	hollows	hollowws	hollơws
schooolhouse	schoolhouse	schooolhouse	schôolhouse
overtoook	overtook	overtoook	overtôok
wooodstock	woodstock	uoodstock	wôodstock
farawway	faraway	farawway	farăway
upkeeep	upkeep	upkeeep	upkêep
volunteeering	volunteering	volunteeering	voluntêering
sparrowws	sparrows	sparrowws	sparrơws
overseeeing	overseeing	overseeeing	oversêeing
fredddy	freddy	fredddy	fređdy
cuckooo	cuckoo	cuckooo	cuckôo
overseeers	overseers	overseeers	oversêers
showwcase	showcase	showwcase	shơwcase
nineteeenthcentury	nineteenthcentury	nineteeenthcentury	ninetêenthcentury
shoooter	shooter	shoooter	shôoter
crowwell	crowell	crowwell	crơwell
maddden	madden	maddden	mađden
foreshadowwed	foreshadowed	foreshadowwed	foreshadơwed
coop	coop	côp	côp
guideboook	guidebook	guideboook	guidebôok
zoooplankton	zooplankton	zoooplankton	zôoplankton
jamestowwn	jamestown	jamestowwn	jamestơwn
cracoww	cracow	cracoww	cracơw
grooomed	groomed	grooomed	grôomed
creee	cree	creee	crêe
rangooon	rangoon	rangooon	rangôon
steeers	steers	steeers	stêers
attleee	attlee	attleee	attlêe
wooodwork	woodwork	uoodwork	wôodwork
bidddle	biddle	bidddle	biđdle
fatherhoood	fatherhood	fatherhoood	fatherhôod
saws	saws	sắ	săs
widowwer	widower	widowwer	widơwer
retireees	retirees	retireees	retirêes
sightseeeing	sightseeing	sightseeeing	sightsêeing
harroww	harrow	haroww	harrơw
hoddder	hodder	hoddder	hođder
ridddled	riddled	ridddled	riđdled
schooolteacher	schoolteacher	schooolteacher	schôolteacher
kiddd	kidd	kiddd	kiđd
belloww	bellow	belloww	bellơw
freeezes	freezes	freeezes	frêezes
slooop	sloop	slooop	slôop
fawwn	fawn	fawwn	făwn
flooodplain	floodplain	flooodplain	flôodplain
streeetcar	streetcar	streeetcar	strêetcar
sprawwl	sprawl	sprawwl	sprăwl
drowwsy	drowsy	drowwsy	drơwsy
furrowws	furrows	furrowws	furrơws
sadddles	saddles	sadddles	sađdles
geeertz	geertz	geeertz	gêertz
biddders	bidders	biddders	biđders
scarecroww	scarecrow	scarecroww	scarecrơw
steeed	steed	steeed	stêed
pudddle	puddle	pudddle	puđdle
preeeminent	preeminent	preeeminent	prêeminent
undergrowwth	undergrowth	undergrowwth	undergrơwth
gidddy	giddy	gidddy	giđdy
cocoon	cocoon	cocon	cocôn
freeemen	freemen	freeemen	frêemen
growwl	growl	growwl	grơwl
schoooled	schooled	schoooled	schôoled
harrowwing	harrowing	harowwing	harrơwing
booze	booze	boe	bôze
sneeer	sneer	sneeer	snêer
ree	ree	rê	rê
slowwdowwn	slowdown	slowwdowwn	slơwdơwn
redrawwn	redrawn	redrawwn	redrăwn
addder	adder	addder	ađder
edddies	eddies	edddies	eđdies
malinowwski	malinowski	malinowwski	malinơwski
clowwns	clowns	clowwns	clơwns
preschooolers	preschoolers	preschooolers	preschôolers
sadddened	saddened	sadddened	sađdened
disallowwed	disallowed	disallowwed	disallơwed
midddletowwn	middletown	midddletowwn	miđdletơwn
crowwe	crowe	crowwe	crơwe
waterfowwl	waterfowl	waterfowwl	waterfơwl
ludloww	ludlow	ludloww	ludlơw
sundowwn	sundown	sundowwn	sundơwn
dragooons	dragoons	dragooons	dragôons
fianceee	fiancee	fianceee	fiancêe
cauliflowwer	cauliflower	cauliflowwer	cauliflơwer
freeehold	freehold	freeehold	frêehold
shampooo	shampoo	shampooo	shampôo
speeeded	speeded	speeeded	spêeded
spoool	spool	spoool	spôol
flawwless	flawless	flawwless	flăwless
greeenville	greenville	greeenville	grêenville
unknowwable	unknowable	unknowwable	unknơwable
untowward	untoward	untowward	untơward
heywoood	heywood	heywoood	heywôod
mckeee	mckee	mckeee	mckêe
endoww	endow	endoww	endơw
gnawwing	gnawing	gnawwing	gnăwing
claddding	cladding	claddding	clađding
detaineees	detainees	detaineees	detainêes
buddd	budd	buddd	buđd
scowwled	scowled	scowwled	scơwled
adddams	addams	adddams	ađdams
lagooons	lagoons	lagooons	lagôons
bellowwed	bellowed	bellowwed	bellơwed
foootprint	footprint	foootprint	fôotprint
foooling	fooling	foooling	fôoling
coo	coo	cô	cô
imbeddded	imbedded	imbeddded	imbeđded
foooter	footer	foooter	fôoter
coon	coon	côn	côn
neighbourhooods	neighbourhoods	neighbourhooods	neighbourhôods
knowwer	knower	knowwer	knơwer
seers	seers	sế	sêrs
wooolly	woolly	uoolly	wôolly
proddded	prodded	proddded	prođded
coookboook	cookbook	cookboook	côokbôok
laddd	ladd	laddd	lađd
inbreeeding	inbreeding	inbreeeding	inbrêeding
scrapboook	scrapbook	scrapboook	scrapbôok
ncaaa	ncaa	ncaaa	ncâa
leveee	levee	leveee	levêe
salooons	saloons	salooons	salôons
collingwoood	collingwood	collingwoood	collingwôod
browwned	browned	browwned	brơwned
granteee	grantee	granteee	grantêe
troddden	trodden	troddden	trođden
narrowwness	narrowness	narowwness	narrơwness
blowwer	blower	blowwer	blơwer
fowwls	fowls	fowwls	fơwls
sneeered	sneered	sneeered	snêered
mudddled	muddled	mudddled	muđdled
gazetteeer	gazetteer	gazetteeer	gazettêer
shawwn	shawn	shawwn	shăwn
fooodgrains	foodgrains	fooodgrains	fôodgrains
overpowwered	overpowered	overpowwered	overpơwered
shopkeeeper	shopkeeper	shopkeeeper	shopkêeper
booms	booms	bốm	bôms
homewoood	homewood	homewoood	homewôod
medddling	meddling	medddling	međdling
roost	roost	rốt	rôst
lows	lows	lớ	lơs
creeeps	creeps	creeeps	crêeps
doneee	donee	doneee	donêe
innkeeeper	innkeeper	innkeeeper	innkêeper
mudddle	muddle	mudddle	muđdle
pureee	puree	pủee	purêe
puree	puree	pủee	purê
hoops	hoops	hốp	hôps
noose	noose	nốe	nôse
adddendum	addendum	adddendum	ađdendum
mee	mee	mê	mê
feeedings	feedings	feeedings	fêedings
yorktowwn	yorktown	yorktowwn	yorktơwn
bigeloww	bigelow	bigeloww	bigelơw
sourceboook	sourcebook	sourceboook	sourcebôok
preeemptive	preemptive	preeemptive	prêemptive
cottonwoood	cottonwood	cottonwoood	cottonwôod
beseeech	beseech	béeech	besêech
beseech	beseech	béech	besêch
widowwhoood	widowhood	widowwhood	widơwhôod
stowwed	stowed	stowwed	stơwed
groooved	grooved	groooved	grôoved
showwdowwn	showdown	showwdowwn	shơwdơwn
vooodooo	voodoo	voodooo	vôodôo
colleeen	colleen	colleeen	collêen
marloww	marlow	marloww	marlơw
arrowwheads	arrowheads	arowwheads	arrơwheads
uaw	uaw	ưa	uă
arrowwhead	arrowhead	arowwhead	arrơwhead
outflowws	outflows	outflowws	outflơws
shudddering	shuddering	shudddering	shuđdering
croooks	crooks	croooks	crôoks
showwy	showy	showwy	shơwy
hoofs	hoofs	hố	hôfs
mow	mow	mơ	mơ
nightgowwn	nightgown	nightgowwn	nightgơwn
feeebly	feebly	feeebly	fêebly
preeemption	preemption	preeemption	prêemption
stodddard	stoddard	stodddard	stođdard
stoww	stow	stoww	stơw
hollowwed	hollowed	hollowwed	hollơwed
uptowwn	uptown	uptowwn	uptơwn
steeeple	steeple	steeeple	stêeple
barrowws	barrows	barowws	barrơws
sheeehan	sheehan	sheeehan	shêehan
spreadsheeets	spreadsheets	spreadsheeets	spreadshêets
midddleclass	middleclass	midddleclass	miđdleclass
gedddes	geddes	gedddes	geđdes
flowwery	flowery	flowwery	flơwery
redddened	reddened	redddened	ređdened
blooodless	bloodless	blooodless	blôodless
mukherjeee	mukherjee	mukherjeee	mukherjêe
haywoood	haywood	haywoood	haywôod
homeowwner	homeowner	homeowwner	homeơwner
sleeepers	sleepers	sleeepers	slêepers
adddictions	addictions	adddictions	ađdictions
gaap	gaap	gâp	gâp
speeer	speer	speeer	spêer
greeensboro	greensboro	greeensboro	grêensboro
unknowwingly	unknowingly	unknowwingly	unknơwingly
talloww	tallow	talloww	tallơw
jigsaww	jigsaw	jigsaww	jigsăw
shallowwer	shallower	shallowwer	shallơwer
livelihooods	livelihoods	livelihooods	livelihôods
chatterjeee	chatterjee	chatterjeee	chatterjêe
franchiseee	franchisee	franchiseee	franchisêe
domineeering	domineering	domineeering	dominêering
looser	looser	lổe	lôser
licenseees	licensees	licenseees	licensêes
burrowwing	burrowing	burowwing	burrơwing
underfooot	underfoot	underfooot	underfôot
darroww	darrow	daroww	darrơw
wooodcock	woodcock	uoodcock	wôodcock
padddling	paddling	padddling	pađdling
headddress	headdress	headddress	heađdress
firepowwer	firepower	firepowwer	firepơwer
berkowwitz	berkowitz	berkowwitz	berkơwitz
broooch	brooch	broooch	brôoch
empowwers	empowers	empowwers	empơwers
aas	aas	ấ	âs
madddox	maddox	madddox	mađdox
wooodcut	woodcut	uoodcut	wôodcut
shadowwing	shadowing	shadowwing	shadơwing
lansdowwne	lansdowne	lansdowwne	lansdơwne
threeedimensional	threedimensional	threeedimensional	thrêedimensional
kilowwatt	kilowatt	kilowwatt	kilơwatt
choctaww	choctaw	choctaww	choctăw
soo	soo	sô	sô
stoooping	stooping	stoooping	stôoping
followwup	followup	followwup	follơwup
greeenery	greenery	greeenery	grêenery
crooom	croom	crooom	crôom
touchdowwn	touchdown	touchdowwn	touchdơwn
unlawwfully	unlawfully	unlawwfully	unlăwfully
babooons	baboons	babooons	babôons
offshooot	offshoot	ofshooot	offshôot
preeeminence	preeminence	preeeminence	prêeminence
agreeeably	agreeably	agreeeably	agrêeably
proddding	prodding	proddding	prođding
kleee	klee	kleee	klêe
meer	meer	mể	mêr
boookkeeeper	bookkeeper	bookkeeeper	bôokkêeper
padddock	paddock	padddock	pađdock
chedddar	cheddar	chedddar	cheđdar
knowwable	knowable	knowwable	knơwable
aan	aan	ân	ân
warszawwa	warszawa	warszawwa	warszăwa
tallahasseee	tallahassee	tallahasseee	tallahassêe
growwling	growling	growwling	grơwling
blooomsbury	bloomsbury	blooomsbury	blôomsbury
freeemasonry	freemasonry	freeemasonry	frêemasonry
padddles	paddles	padddles	pađdles
heen	heen	hên	hên
knighthoood	knighthood	knighthoood	knighthôod
narrowwest	narrowest	narowwest	narrơwest
entreee	entree	entreee	entrêe
outgrowwn	outgrown	outgrowwn	outgrơwn
shawwneee	shawnee	shawwneee	shăwnêe
loon	loon	lôn	lôn
bestowws	bestows	bestowws	bestơws
hathawway	hathaway	hathawway	hathăway
addductor	adductor	addductor	ađductor
furrowwed	furrowed	furrowwed	furrơwed
strawws	straws	strawws	străws
wooodpecker	woodpecker	uoodpecker	wôodpecker
banerjeee	banerjee	banerjeee	banerjêe
mayflowwer	mayflower	mayflowwer	mayflơwer
rheee	rhee	rheee	rhêe
babooon	baboon	babooon	babôon
slowwest	slowest	slowwest	slơwest
prooofreading	proofreading	prooofreading	prôofreading
peshawwar	peshawar	peshawwar	peshăwar
greeets	greets	greeets	grêets
midddling	middling	midddling	miđdling
sows	sows	sớ	sơs
woooing	wooing	uooing	wôoing
spreee	spree	spreee	sprêe
inlaww	inlaw	inlaww	inlăw
unacknowwledged	unacknowledged	unacknowwledged	unacknơwledged
kalamazooo	kalamazoo	kalamazooo	kalamazôo
hudddle	huddle	hudddle	huđdle
appelleee	appellee	appelleee	appellêe
auctioneeer	auctioneer	auctioneeer	auctionêer
wildflowwers	wildflowers	wildflowwers	wildflơwers
hoo	hoo	hô	hô
kee	kee	kê	kê
overflowwed	overflowed	overflowwed	overflơwed
rostow	rostow	rớt	rostơ
foootman	footman	foootman	fôotman
snowwfall	snowfall	snowwfall	snơwfall
screeeching	screeching	screeeching	scrêeching
tattoooed	tattooed	tattoooed	tattôoed
scowwl	scowl	scowwl	scơwl
overriddden	overridden	overriddden	overriđden
yellowws	yellows	yellowws	yellơws
fidddler	fiddler	fidddler	fiđdler
bestowwing	bestowing	bestowwing	bestơwing
schooolrooom	schoolroom	schooolrooom	schôolrôom
noaa	noaa	noâ	noâ
medddle	meddle	medddle	međdle
lidddell	liddell	lidddell	liđdell
shipowwners	shipowners	shipowwners	shipơwners
shallowws	shallows	shallowws	shallơws
wooodworking	woodworking	uoodworking	wôodworking
knowwledges	knowledges	knowwledges	knơwledges
greeenspan	greenspan	greeenspan	grêenspan
raccooon	raccoon	raccooon	raccôon
snowwball	snowball	snowwball	snơwball
clawwed	clawed	clawwed	clăwed
soddden	sodden	soddden	sođden
midddleman	middleman	midddleman	miđdleman
browwnian	brownian	browwnian	brơwnian
tattooos	tattoos	tattooos	tattôos
pudddles	puddles	pudddles	puđdles
microoorganism	microorganism	microoorganism	micrôorganism
screeech	screech	screeech	scrêech
reeengineeering	reengineering	reengineeering	rêenginêering
shipowwner	shipowner	shipowwner	shipơwner
grooot	groot	grooot	grôot
browwnsville	brownsville	browwnsville	brơwnsville
doo	doo	dô	dô
squaww	squaw	squaww	squăw
wooodbury	woodbury	uoodbury	wôodbury
holbroook	holbrook	holbroook	holbrôok
attendeees	attendees	attendeees	attendêes
typhooon	typhoon	typhooon	typhôon
uncoooperative	uncooperative	uncoooperative	uncôoperative
fleees	flees	fleees	flêes
overgrowwth	overgrowth	overgrowwth	overgrơwth
storerooom	storeroom	storerooom	storerôom
sudddenness	suddenness	sudddenness	suđdenness
bradddock	braddock	bradddock	brađdock
swooop	swoop	suoop	swôop
veer	veer	vể	vêr
stradddle	straddle	stradddle	strađdle
runawways	runaways	runawways	runăways
mageee	magee	mageee	magêe
apogeee	apogee	apogeee	apogêe
moo	moo	mô	mô
privateeers	privateers	privateeers	privatêers
ghee	ghee	ghê	ghê
gleeefully	gleefully	gleeefully	glêefully
flywheeel	flywheel	flywheeel	flywhêel
sheeeting	sheeting	sheeeting	shêeting
zooos	zoos	zooos	zôos
eighteeenthcentury	eighteenthcentury	eighteeenthcentury	eightêenthcentury
odddity	oddity	odddity	ođdity
proww	prow	proww	prơw
sneeezing	sneezing	sneeezing	snêezing
shoootings	shootings	shoootings	shôotings
caa	caa	câ	câ
lightfooot	lightfoot	lightfooot	lightfôot
broookes	brookes	broookes	brôokes
wooodbridge	woodbridge	uoodbridge	wôodbridge
swoooped	swooped	suooped	swôoped
patenteee	patentee	patenteee	patentêe
padddled	paddled	padddled	pađdled
freeestanding	freestanding	freeestanding	frêestanding
mountaineeers	mountaineers	mountaineeers	mountainêers
selfesteeem	selfesteem	selfesteeem	selfestêem
billowwing	billowing	billowwing	billơwing
zeee	zee	zeee	zêe
ideee	idee	ideee	idêe
scrawwled	scrawled	scrawwled	scrăwled
beaverbroook	beaverbrook	beaverbroook	beaverbrôok
gatekeeeper	gatekeeper	gatekeeeper	gatekêeper
wooodhouse	woodhouse	uoodhouse	wôodhouse
subcommitteees	subcommittees	subcommitteees	subcommittêes
charlestowwn	charlestown	charlestowwn	charlestơwn
pedddlers	peddlers	pedddlers	peđdlers
unawwares	unawares	unawwares	unăwares
bradstreeet	bradstreet	bradstreeet	bradstrêet
fooolhardy	foolhardy	fooolhardy	fôolhardy
bungalowws	bungalows	bungalowws	bungalơws
madddening	maddening	madddening	mađdening
eastwoood	eastwood	eastwoood	eastwôod
saar	saar	sar	sâr
bluetoooth	bluetooth	bluetoooth	bluetôoth
outloooks	outlooks	outloooks	outlôoks
iaa	iaa	iâ	iâ
blooodthirsty	bloodthirsty	blooodthirsty	blôodthirsty
alooofness	aloofness	alooofness	alôofness
brawwl	brawl	brawwl	brăwl
breeen	breen	breeen	brêen
chinoook	chinook	chinoook	chinôok
thadddeus	thaddeus	thadddeus	thađdeus
pawwneee	pawnee	pawneee	păwnêe
foootpath	footpath	foootpath	fôotpath
kuwwaiti	kuwaiti	kuwwaiti	kưwaiti
overthrowwing	overthrowing	overthrowwing	overthrơwing
evergreeens	evergreens	evergreeens	evergrêens
schooolwork	schoolwork	schooolwork	schôolwork
shodddy	shoddy	shodddy	shođdy
greeener	greener	greeener	grêener
glowws	glows	glowws	glơws
addduction	adduction	addduction	ađduction
shawwls	shawls	shawwls	shăwls
ooze	ooze	oe	ôze
sawn	sawn	săn	săn
dowwntroddden	downtrodden	downtroddden	dơwntrođden
greeenpeace	greenpeace	greeenpeace	grêenpeace
threees	threes	threees	thrêes
sleeeved	sleeved	sleeeved	slêeved
snowwstorm	snowstorm	snowwstorm	snơwstorm
dodds	dodds	đó	dođs
greeenhouses	greenhouses	greeenhouses	grêenhouses
blooomed	bloomed	blooomed	blôomed
pedddler	peddler	pedddler	peđdler
wooodcuts	woodcuts	uoodcuts	wôodcuts
mcgowwan	mcgowan	mcgowwan	mcgơwan
broookfield	brookfield	broookfield	brôokfield
oversaww	oversaw	oversaww	oversăw
krakoww	krakow	krakoww	krakơw
groooms	grooms	groooms	grôoms
glooomily	gloomily	glooomily	glôomily
middden	midden	middden	miđden
plowws	plows	plowws	plơws
willpowwer	willpower	willpowwer	willpơwer
godddamned	goddamned	godddamned	gođdamned
greeedily	greedily	greeedily	grêedily
preeempted	preempted	preeempted	prêempted
overseees	oversees	overseees	oversêes
hobsbawwm	hobsbawm	hobsbawwm	hobsbăwm
pawns	pawns	pắn	păns
mcgrawwhill	mcgrawhill	mcgrawwhill	mcgrăwhill
overflowws	overflows	overflowws	overflơws
stradddling	straddling	stradddling	strađdling
foreshadowwing	foreshadowing	foreshadowwing	foreshadơwing
ceee	cee	ceee	cêe
kawwasaki	kawasaki	kawwasaki	kăwasaki
sleeet	sleet	sleeet	slêet
crawwley	crawley	crawwley	crăwley
chee	chee	chê	chê
browwnell	brownell	browwnell	brơwnell
yee	yee	yê	yê
spooonful	spoonful	spooonful	spôonful
bittersweeet	bittersweet	bittersweeet	bitterswêet
showwrooom	showroom	showwrooom	shơwrôom
brooods	broods	brooods	brôods
sadddest	saddest	sadddest	sađdest
uncooordinated	uncoordinated	uncooordinated	uncôordinated
overshooot	overshoot	overshooot	overshôot
ploddding	plodding	ploddding	plođding
naa	naa	nâ	nâ
drooop	droop	drooop	drôop
wooolley	woolley	uoolley	wôolley
ruddd	rudd	ruddd	ruđd
rainbowws	rainbows	rainbowws	rainbơws
roos	roos	rố	rôs
pocketboook	pocketbook	pocketboook	pocketbôok
adddie	addie	adddie	ađdie
reprooof	reproof	reprooof	reprôof
driftwoood	driftwood	driftwoood	driftwôod
scowwling	scowling	scowwling	scơwling
gatekeeepers	gatekeepers	gatekeeepers	gatekêepers
freeehand	freehand	freeehand	frêehand
yarroww	yarrow	yarroww	yarrơw
crowwther	crowther	crowwther	crơwther
reddding	redding	reddding	ređding
loos	loos	lố	lôs
midddleware	middleware	midddleware	miđdleware
prowwling	prowling	prowwling	prơwling
drawwled	drawled	drawwled	drăwled
steeely	steely	steeely	stêely
mawr	mawr	mẳ	măr
foreknowwledge	foreknowledge	foreknowwledge	foreknơwledge
unheeeded	unheeded	unheeeded	unhêeded
fidddling	fiddling	fidddling	fiđdling
forenooon	forenoon	forenooon	forenôon
prawwns	prawns	prawwns	prăwns
wooodman	woodman	uoodman	wôodman
ageee	agee	ageee	agêe
platooons	platoons	platooons	platôons
sleeepiness	sleepiness	sleeepiness	slêepiness
sneeeze	sneeze	sneeeze	snêeze
newsrooom	newsroom	newsrooom	newsrôom
appointeee	appointee	appointeee	appointêe
scoooter	scooter	scoooter	scôoter
overshadoww	overshadow	overshadoww	overshadơw
browwnie	brownie	browwnie	brơwnie
broooded	brooded	broooded	brôoded
leveees	levees	leveees	levêes
microwwaves	microwaves	microwwaves	micrơwaves
foootings	footings	foootings	fôotings
meleee	melee	meleee	melêe
blackfooot	blackfoot	blackfooot	blackfôot
wooodson	woodson	uoodson	wôodson
uw	uw	ư	ư
greeening	greening	greeening	grêening
steeelworkers	steelworkers	steeelworkers	stêelworkers
falsehooods	falsehoods	falsehooods	falsehôods
storekeeeper	storekeeper	storekeeeper	storekêeper
getawway	getaway	getawway	getăway
bellowwing	bellowing	bellowwing	bellơwing
freeetowwn	freetown	freeetowwn	frêetơwn
maas	maas	mấ	mâs
maccabeees	maccabees	maccabeees	maccabêes
vee	vee	vê	vê
jeeeps	jeeps	jeeeps	jêeps
hoot	hoot	hôt	hôt
midtowwn	midtown	midtowwn	midtơwn
rundowwn	rundown	rundowwn	rundơwn
gnawwed	gnawed	gnawwed	gnăwed
indiscreeet	indiscreet	indiscreeet	indiscrêet
freeeport	freeport	freeeport	frêeport
greeenleaf	greenleaf	greeenleaf	grêenleaf
landowwning	landowning	landowwning	landơwning
backwooods	backwoods	backwooods	backwôods
kiddder	kidder	kiddder	kiđder
poop	poop	pôp	pôp
sandalwoood	sandalwood	sandalwoood	sandalwôod
goo	goo	gô	gô
checkboook	checkbook	checkboook	checkbôok
sheeepishly	sheepishly	sheeepishly	shêepishly
droooped	drooped	droooped	drôoped
pedddling	peddling	pedddling	peđdling
blooods	bloods	blooods	blôods
iooo	ioo	iooo	iôo
aimeee	aimee	aimeee	aimêe
mcfaddden	mcfadden	mcfaddden	mcfađden
breeezy	breezy	breeezy	brêezy
wheeelbarroww	wheelbarrow	wheelbarroww	whêelbarrơw
showwering	showering	showwering	shơwering
aladddin	aladdin	aladddin	alađdin
schooolboys	schoolboys	schooolboys	schôolboys
mountaineeering	mountaineering	mountaineeering	mountainêering
snowwden	snowden	snowwden	snơwden
salloww	sallow	salloww	sallơw
madddie	maddie	madddie	mađdie
snowwing	snowing	snowwing	snơwing
creeepy	creepy	creeepy	crêepy
padddington	paddington	padddington	pađdington
entreees	entrees	entreees	entrêes
tycooon	tycoon	tycooon	tycôon
bassooon	bassoon	basooon	bassôon
tees	tees	tế	tês
overpowwer	overpower	overpowwer	overpơwer
avowwedly	avowedly	avowwedly	avơwedly
steeen	steen	steeen	stêen
fooo	foo	fooo	fôo
greeenblatt	greenblatt	greeenblatt	grêenblatt
shoooters	shooters	shoooters	shôoters
stanislaww	stanislaw	stanislaww	stanislăw
fooolprooof	foolproof	fooolprooof	fôolprôof
soloww	solow	soloww	solơw
mutineeers	mutineers	mutineeers	mutinêers
leer	leer	lể	lêr
hydropowwer	hydropower	hydropowwer	hydropơwer
tomahawwk	tomahawk	tomahawwk	tomahăwk
crackdowwn	crackdown	crackdowwn	crackdơwn
sulawwesi	sulawesi	sulawwesi	sulăwesi
snowwflakes	snowflakes	snowwflakes	snơwflakes
staaat	staat	staaat	stâat
plowwman	plowman	plowwman	plơwman
schooolgirl	schoolgirl	schooolgirl	schôolgirl
baileee	bailee	baileee	bailêe
sassooon	sassoon	sasooon	sassôon
odddities	oddities	odddities	ođdities
edddington	eddington	edddington	eđdington
yellowwing	yellowing	yellowwing	yellơwing
baa	baa	bâ	bâ
saa	saa	sâ	sâ
screeeched	screeched	screeeched	scrêeched
spoooner	spooner	spoooner	spôoner
franchiseees	franchisees	franchiseees	franchisêes
uncoooked	uncooked	uncoooked	uncôoked
camerooons	cameroons	camerooons	camerôons
flooored	floored	flooored	flôored
schooolteachers	schoolteachers	schooolteachers	schôolteachers
riddding	ridding	riddding	riđding
preeempt	preempt	preeempt	prêempt
madddy	maddy	madddy	mađdy
hadddock	haddock	hadddock	hađdock
dogwoood	dogwood	dogwoood	dogwôod
prooofing	proofing	prooofing	prôofing
freeeholders	freeholders	freeeholders	frêeholders
scroooge	scrooge	scroooge	scrôoge
cadddy	caddy	cadddy	cađdy
guideboooks	guidebooks	guideboooks	guidebôoks
skiddded	skidded	skiddded	skiđded
brooome	broome	brooome	brôome
onloooker	onlooker	onloooker	onlôoker
cottonseeed	cottonseed	cottonseeed	cottonsêed
spoooky	spooky	spoooky	spôoky
schoooners	schooners	schoooners	schôoners
yahooo	yahoo	yahooo	yahôo
dawns	dawns	dắn	dăns
frowwns	frowns	frowwns	frơwns
regrowwth	regrowth	regrowwth	regrơwth
subtreee	subtree	subtreee	subtrêe
recordkeeeping	recordkeeping	recordkeeeping	recordkêeping
balaaam	balaam	balaaam	balâam
billowws	billows	billowws	billơws
flooorboards	floorboards	flooorboards	flôorboards
ishikawwa	ishikawa	ishikawwa	ishikăwa
matineee	matinee	matineee	matinêe
blowwers	blowers	blowwers	blơwers
kneeels	kneels	kneeels	knêels
zeeeman	zeeman	zeeeman	zêeman
breakawway	breakaway	breakawway	breakăway
murroww	murrow	muroww	murrơw
steeepest	steepest	steeepest	stêepest
godddam	goddam	godddam	gođdam
bleeeds	bleeds	bleeeds	blêeds
biddden	bidden	biddden	biđden
bazaaars	bazaars	bazaaars	bazâars
redeeemable	redeemable	redeeemable	redêemable
cocoons	cocoons	cocons	cocôns
wroclaww	wroclaw	wroclaww	wroclăw
dowd	dowd	đơ	dơd
straightawway	straightaway	straightawway	straightăway
schooolmasters	schoolmasters	schooolmasters	schôolmasters
roo	roo	rô	rô
windowwless	windowless	windowwless	windơwless
newsreeel	newsreel	newsreeel	newsrêel
disavowwed	disavowed	disavowwed	disavơwed
feeedstock	feedstock	feeedstock	fêedstock
interneees	internees	interneees	internêes
saginaww	saginaw	saginaww	saginăw
windowwsill	windowsill	windowwsill	windơwsill
heddda	hedda	heddda	heđda
preeeclampsia	preeclampsia	preeeclampsia	prêeclampsia
watertowwn	watertown	watertowwn	watertơwn
kooo	koo	kooo	kôo
scrawwny	scrawny	scrawwny	scrăwny
fuelwoood	fuelwood	fuelwoood	fuelwôod
albeee	albee	albeee	albêe
creeeper	creeper	creeeper	crêeper
brouwwer	brouwer	brouwwer	broưwer
handlooom	handloom	handlooom	handlôom
mcqueeen	mcqueen	mcqueeen	mcquêen
freeemasons	freemasons	freeemasons	frêemasons
countdowwn	countdown	countdowwn	countdơwn
wooodford	woodford	uoodford	wôodford
tattoooing	tattooing	tattoooing	tattôoing
freeeways	freeways	freeeways	frêeways
gidddings	giddings	gidddings	giđdings
saddder	sadder	saddder	sađder
outlawwing	outlawing	outlawwing	outlăwing
blooodied	bloodied	blooodied	blôodied
feeedforward	feedforward	feeedforward	fêedforward
steeepness	steepness	steeepness	stêepness
woooed	wooed	uooed	wôoed
youngstowwn	youngstown	youngstowwn	youngstơwn
jowwett	jowett	jowwett	jơwett
unknowwing	unknowing	unknowwing	unknơwing
broooms	brooms	broooms	brôoms
drawwdowwn	drawdown	drawwdowwn	drăwdơwn
drawwl	drawl	drawwl	drăwl
sneeering	sneering	sneeering	snêering
steeeds	steeds	steeeds	stêeds
zoooming	zooming	zoooming	zôoming
browwer	brower	browwer	brơwer
screeenwriter	screenwriter	screeenwriter	scrêenwriter
privateeer	privateer	privateeer	privatêer
snowwed	snowed	snowwed	snơwed
crawwls	crawls	crawwls	crăwls
blackfeeet	blackfeet	blackfeeet	blackfêet
clawwing	clawing	clawwing	clăwing
brotherhooods	brotherhoods	brotherhooods	brotherhôods
saddduceees	sadducees	saddduceees	sađducêes
lesseees	lessees	leseees	lessêes
poore	poore	pổe	pôre
stradddled	straddled	stradddled	strađdled
throwwer	thrower	throwwer	thrơwer
sheeepskin	sheepskin	sheeepskin	shêepskin
bedriddden	bedridden	bedriddden	bedriđden
squeeezes	squeezes	squeeezes	squêezes
redddening	reddening	redddening	ređdening
blooodshot	bloodshot	blooodshot	blôodshot
creeel	creel	creeel	crêel
foreshadowws	foreshadows	foreshadowws	foreshadơws
pudddings	puddings	pudddings	puđdings
canteeens	canteens	canteeens	cantêens
addduce	adduce	addduce	ađduce
pedigreees	pedigrees	pedigreees	pedigrêes
sheee	shee	sheee	shêe
dde	dde	đe	đe
endowws	endows	endowws	endơws
showwman	showman	showwman	shơwman
gooch	gooch	gôch	gôch
rabinowwitz	rabinowitz	rabinowwitz	rabinơwitz
addducts	adducts	addducts	ađducts
oilseeeds	oilseeds	oilseeeds	oilsêeds
offereee	offeree	ofereee	offerêe
knowweth	knoweth	knowweth	knơweth
sunflowwers	sunflowers	sunflowwers	sunflơwers
greeenstone	greenstone	greeenstone	grêenstone
wooolworth	woolworth	uoolworth	wôolworth
foootmen	footmen	foootmen	fôotmen
walloww	wallow	walloww	wallơw
fleeetwoood	fleetwood	fleeetwoood	flêetwôod
germantowwn	germantown	germantowwn	germantơwn
mountaineeer	mountaineer	mountaineeer	mountainêer
returneees	returnees	returneees	returnêes
chickasaww	chickasaw	chickasaww	chickasăw
scuddder	scudder	scuddder	scuđder
screeenings	screenings	screeenings	scrêenings
disavowwal	disavowal	disavowwal	disavơwal
pontooon	pontoon	pontooon	pontôon
rowwntreee	rowntree	rowntreee	rơwntrêe
setteee	settee	setteee	settêe
vendeee	vendee	vendeee	vendêe
seaflooor	seafloor	seaflooor	seaflôor
addduct	adduct	addduct	ađduct
hetweeen	hetween	hetweeen	hetwêen
kowwlooon	kowloon	kowwlooon	kơwlôon
crowwing	crowing	crowwing	crơwing
granteees	grantees	granteees	grantêes
quickboooks	quickbooks	quickboooks	quickbôoks
kowwalski	kowalski	kowwalski	kơwalski
swooon	swoon	suoon	swôon
maa	maa	mâ	mâ
browwnies	brownies	browwnies	brơwnies
paa	paa	pâ	pâ
zooologist	zoologist	zooologist	zôologist
bristoww	bristow	bristoww	bristơw
uddder	udder	uddder	uđder
nauvooo	nauvoo	nauvooo	nauvôo
kilowwatts	kilowatts	kilowwatts	kilơwatts
yellowwed	yellowed	yellowwed	yellơwed
elwoood	elwood	elwoood	elwôod
prowwl	prowl	prowwl	prơwl
wallowwing	wallowing	wallowwing	wallơwing
meerut	meerut	mểut	mêrut
foreseeeing	foreseeing	foreseeeing	foresêeing
rickshaww	rickshaw	rickshaww	rickshăw
nowak	nowak	nơak	nơak
kangarooos	kangaroos	kangarooos	kangarôos
strawwson	strawson	strawwson	străwson
sauteeed	sauteed	sauteeed	sautêed
maddder	madder	maddder	mađder
ogawwa	ogawa	ogawwa	ogăwa
hadddon	haddon	hadddon	hađdon
jeeered	jeered	jeeered	jêered
kershaww	kershaw	kershaww	kershăw
hadddad	haddad	hadddad	hađdad
yearboooks	yearbooks	yearboooks	yearbôoks
schooolmates	schoolmates	schooolmates	schôolmates
offshooots	offshoots	ofshooots	offshôots
woooster	wooster	uooster	wôoster
prooofread	proofread	prooofread	prôofread
callawway	callaway	callawway	callăway
knowwest	knowest	knowwest	knơwest
embedddedness	embeddedness	embedddedness	embeđdedness
bambooos	bamboos	bambooos	bambôos
broooches	brooches	broooches	brôoches
greeenwald	greenwald	greeenwald	grêenwald
dragooon	dragoon	dragooon	dragôon
moos	moos	mố	môs
zooomed	zoomed	zooomed	zôomed
disavoww	disavow	disavoww	disavơw
broookhaven	brookhaven	broookhaven	brôokhaven
disalloww	disallow	disalloww	disallơw
appelleees	appellees	appelleees	appellêes
crenshaww	crenshaw	crenshaww	crenshăw
madddened	maddened	madddened	mađdened
heathroww	heathrow	heathroww	heathrơw
seeps	seeps	sếp	sêps
mcadooo	mcadoo	mcadooo	mcadôo
aileeen	aileen	aileeen	ailêen
endowwing	endowing	endowwing	endơwing
avowwal	avowal	avowwal	avơwal
crowwder	crowder	crowwder	crơwder
knowwlton	knowlton	knowwlton	knơwlton
enfeeebled	enfeebled	èneebled	enfêebled
enfeebled	enfeebled	ènebled	enfêbled
profiteeering	profiteering	profiteeering	profitêering
knowwed	knowed	knowwed	knơwed
wooof	woof	uoof	wôof
woof	woof	uồ	wôf
adddr	addr	adddr	ađdr
wooolwich	woolwich	uoolwich	wôolwich
sawwtoooth	sawtooth	sawtoooth	săwtôoth
sleeeplessness	sleeplessness	sleeeplessness	slêeplessness
outgroww	outgrow	outgroww	outgrơw
valleee	vallee	valleee	vallêe
festoooned	festooned	festoooned	festôoned
poo	poo	pô	pô
penseee	pensee	pénee	pensêe
pensee	pensee	péne	pensê
widowwers	widowers	widowwers	widơwers
retireee	retiree	retireee	retirêe
commandeeered	commandeered	commandeeered	commandêered
heer	heer	hể	hêr
provincetowwn	provincetown	provincetowwn	provincetơwn
sketchboook	sketchbook	sketchboook	sketchbôok
sleeepily	sleepily	sleeepily	slêepily
geneseee	genesee	geneseee	genesêe
drawweee	drawee	drawweee	drăwêe
landowwnership	landownership	landowwnership	landơwnership
foreseees	foresees	foreseees	foresêes
scoooping	scooping	scoooping	scôoping
crabtreee	crabtree	crabtreee	crabtrêe
overseeen	overseen	overseeen	oversêen
peachtreee	peachtree	peachtreee	peachtrêe
swoooping	swooping	suooping	swôoping
aac	aac	âc	âc
creeepers	creepers	creeepers	crêepers
scooops	scoops	scooops	scôops
hedgerowws	hedgerows	hedgerowws	hedgerơws
adddenda	addenda	adddenda	ađdenda
racketeeering	racketeering	racketeeering	racketêering
virchoww	virchow	virchoww	virchơw
ridddell	riddell	ridddell	riđdell
coookboooks	cookbooks	cookboooks	côokbôoks
raccooons	raccoons	raccooons	raccôons
choo	choo	chô	chô
droooling	drooling	droooling	drôoling
adddington	addington	adddington	ađdington
budddhahoood	buddhahood	budddhahoood	buđdhahôod
forsoook	forsook	forsoook	forsôok
haar	haar	hẩ	hâr
crowwed	crowed	crowwed	crơwed
muddd	mudd	muddd	muđd
electioneeering	electioneering	electioneeering	electionêering
minkowwski	minkowski	minkowwski	minkơwski
hindooo	hindoo	hindooo	hindôo
sheeepish	sheepish	sheeepish	shêepish
morristowwn	morristown	moristowwn	morristơwn
padddies	paddies	padddies	pađdies
prawwn	prawn	prawwn	prăwn
oops	oops	ốp	ôps
wooolsey	woolsey	uoolsey	wôolsey
beseeeching	beseeching	béeeching	besêeching
browwnloww	brownlow	browwnloww	brơwnlơw
bulawwayo	bulawayo	bulawwayo	bulăwayo
wooodworth	woodworth	uoodworth	wôodworth
naar	naar	nẩ	nâr
broookline	brookline	broookline	brôokline
filigreee	filigree	filigreee	filigrêe
evacueees	evacuees	evacueees	evacuêes
skiddding	skidding	skiddding	skiđding
hasegawwa	hasegawa	hasegawwa	hasegăwa
sidddhartha	siddhartha	sidddhartha	siđdhartha
speeedup	speedup	speeedup	spêedup
heirlooom	heirloom	heirlooom	heirlôom
ieee	iee	ieee	iêe
iee	iee	iê	iê
greeenway	greenway	greeenway	grêenway
scheeer	scheer	scheeer	schêer
playrooom	playroom	playrooom	playrôom
sedddon	seddon	sedddon	seđdon
sheeed	sheed	sheeed	shêed
newtowwn	newtown	newtowwn	newtơwn
interbeddded	interbedded	interbeddded	interbeđded
ddc	ddc	đc	đc
wooodpeckers	woodpeckers	uoodpeckers	wôodpeckers
blooodstained	bloodstained	blooodstained	blôodstained
neem	neem	nêm	nêm
buccaneeers	buccaneers	buccaneeers	buccanêers
behoooves	behooves	behoooves	behôoves
minnoww	minnow	minnoww	minnơw
rodddy	roddy	rodddy	rođdy
whitelaww	whitelaw	whitelaww	whitelăw
mellowwed	mellowed	mellowwed	mellơwed
snoooping	snooping	snoooping	snôoping
wooodwind	woodwind	uoodwind	wôodwind
hankoww	hankow	hankoww	hankơw
sleeeveless	sleeveless	sleeeveless	slêeveless
winnowwing	winnowing	winnowwing	winnơwing
anterooom	anteroom	anterooom	anterôom
crossboww	crossbow	crossboww	crossbơw
mohawwks	mohawks	mohawwks	mohăwks
agloww	aglow	agloww	aglơw
eddd	edd	eddd	eđd
hoookworm	hookworm	hoởkom	hôokworm
farroww	farrow	farroww	farrơw
bidddy	biddy	bidddy	biđdy
reddder	redder	reddder	ređder
streeetcars	streetcars	streeetcars	strêetcars
haan	haan	hân	hân
blackpoool	blackpool	blackpoool	blackpôol
minnowws	minnows	minnowws	minnơws
soong	soong	sông	sông
seawweeeds	seaweeds	seaweeeds	seăwêeds
muldooon	muldoon	muldooon	muldôon
stooops	stoops	stooops	stôops
streeeter	streeter	streeeter	strêeter
westlaww	westlaw	westlaww	westlăw
breee	bree	breee	brêe
foreshadoww	foreshadow	foreshadoww	foreshadơw
steeerage	steerage	steeerage	stêerage
foooters	footers	foooters	fôoters
markowwitz	markowitz	markowwitz	markơwitz
drawwbridge	drawbridge	drawwbridge	drăwbridge
biiloww	biilow	biiloww	biilơw
fireprooof	fireproof	fireprooof	fireprôof
shallowwness	shallowness	shallowwness	shallơwness
browwder	browder	browwder	brơwder
todddy	toddy	todddy	tođdy
moskowwitz	moskowitz	moskowwitz	moskơwitz
ploddded	plodded	ploddded	plođded
snowwflake	snowflake	snowwflake	snơwflake
mcpheee	mcphee	mcpheee	mcphêe
seventeeenthcentury	seventeenthcentury	seventeeenthcentury	seventêenthcentury
snowwman	snowman	snowwman	snơwman
bladdders	bladders	bladdders	blađders
unbeknowwnst	unbeknownst	unbeknowwnst	unbeknơwnst
deadwoood	deadwood	deadwoood	deadwôod
unbiddden	unbidden	unbiddden	unbiđden
rebooot	reboot	rebooot	rebôot
fooodstuff	foodstuff	fooodstuff	fôodstuff
feeelers	feelers	feeelers	fêelers
browwnstone	brownstone	browwnstone	brơwnstone
addditivity	additivity	addditivity	ađditivity
wickloww	wicklow	wickloww	wicklơw
flooodplains	floodplains	flooodplains	flôodplains
forefooot	forefoot	forefooot	forefôot
geeer	geer	geeer	gêer
browwnson	brownson	browwnson	brơwnson
gnaww	gnaw	gnaww	gnăw
flowwcharts	flowcharts	flowwcharts	flơwcharts
teaspooonful	teaspoonful	teaspooonful	teaspôonful
budddhi	buddhi	budddhi	buđdhi
aarp	aarp	ẩp	ârp
badddeley	baddeley	badddeley	bađdeley
yazooo	yazoo	yazooo	yazôo
jeeering	jeering	jeeering	jêering
redwooods	redwoods	redwooods	redwôods
scrapboooks	scrapbooks	scrapboooks	scrapbôoks
foootpaths	footpaths	foootpaths	fôotpaths
foootstoool	footstool	foootstoool	fôotstôol
kneeeled	kneeled	kneeeled	knêeled
agrawwal	agrawal	agrawwal	agrăwal
showwalter	showalter	showwalter	shơwalter
spoook	spook	spoook	spôok
gladdden	gladden	gladdden	glađden
greeenstein	greenstein	greeenstein	grêenstein
fleeetingly	fleetingly	fleeetingly	flêetingly
calloww	callow	calloww	callơw
springsteeen	springsteen	springsteeen	springstêen
scoooted	scooted	scoooted	scôoted
callowway	calloway	callowway	callơway
aaf	aaf	ầ	âf
grimshaww	grimshaw	grimshaww	grimshăw
blooomer	bloomer	blooomer	blôomer
redraww	redraw	redraww	redrăw
adopteees	adoptees	adopteees	adoptêes
toot	toot	tôt	tôt
ellwoood	ellwood	ellwoood	ellwôod
poughkeeepsie	poughkeepsie	poughkeeepsie	poughkêepsie
sheeehy	sheehy	sheeehy	shêehy
reparteee	repartee	reparteee	repartêe
dds	dds	đs	đs
steeelhead	steelhead	steeelhead	stêelhead
adddresseees	addressees	adddresseees	ađdressêes
hallowwell	hallowell	hallowwell	hallơwell
showwings	showings	showwings	shơwings
storyboook	storybook	storyboook	storybôok
preeeminently	preeminently	preeeminently	prêeminently
steeeled	steeled	steeeled	stêeled
troubleshooot	troubleshoot	troubleshooot	troubleshôot
throwwback	throwback	throwwback	thrơwback
ees	ees	ế	ês
monsooons	monsoons	mónoons	monsôons
monsoons	monsoons	mónons	monsôns
smooot	smoot	smooot	smôot
homegrowwn	homegrown	homegrowwn	homegrơwn
browwnleee	brownlee	browwnleee	brơwnlêe
meltdowwn	meltdown	meltdowwn	meltdơwn
ozawwa	ozawa	ozawwa	ozăwa
koooning	kooning	koooning	kôoning
burrowwed	burrowed	burowwed	burrơwed
veneers	veneers	veners	venêrs
disallowwance	disallowance	disallowwance	disallơwance
foootlights	footlights	foootlights	fôotlights
heartwoood	heartwood	heartwoood	heartwôod
oop	oop	ôp	ôp
brushwoood	brushwood	brushwoood	brushwôod
blooodletting	bloodletting	blooodletting	blôodletting
buffooon	buffoon	bufooon	buffôon
innkeeepers	innkeepers	innkeeepers	innkêepers
balloooning	ballooning	balloooning	ballôoning
saarc	saarc	sẩc	sârc
highbroww	highbrow	highbroww	highbrơw
oeec	oeec	oêc	oêc
oooooo	oooo	ooooo	ôôô
oooo	oooo	ooo	ôô
streamfloww	streamflow	streamfloww	streamflơw
cudddled	cuddled	cudddled	cuđdled
sorrowwfully	sorrowfully	sorowwfully	sorrơwfully
housekeeepers	housekeepers	housekeeepers	housekêepers
thurloww	thurlow	thurloww	thurlơw
cudddle	cuddle	cudddle	cuđdle
shooo	shoo	shooo	shôo
noor	noor	nổ	nôr
midddleaged	middleaged	midddleaged	miđdleaged
gow	gow	gơ	gơ
showwa	showa	showwa	shơwa
staaats	staats	staaats	stâats
threeequarters	threequarters	threeequarters	thrêequarters
cutawway	cutaway	cutawway	cutăway
eez	eez	e	êz
lyceee	lycee	lyceee	lycêe
glowwered	glowered	glowwered	glơwered
shuddders	shudders	shuddders	shuđders
delawwares	delawares	delawwares	delăwares
midddlemarch	middlemarch	midddlemarch	miđdlemarch
detaineee	detainee	detaineee	detainêe
schooolmen	schoolmen	schooolmen	schôolmen
jedddah	jeddah	jedddah	jeđdah
feeebleness	feebleness	feeebleness	fêebleness
promiseee	promisee	promiseee	promisêe
schooolyard	schoolyard	schooolyard	schôolyard
midafternooon	midafternoon	midafternooon	midafternôon
unneeeded	unneeded	unneeeded	unnêeded
drowwns	drowns	drowwns	drơwns
billoww	billow	billoww	billơw
aftergloww	afterglow	aftergloww	afterglơw
redeeems	redeems	redeeems	redêems
dda	dda	đa	đa
aar	aar	ẩ	âr
growwnups	grownups	growwnups	grơwnups
wooodside	woodside	uoodside	wôodside
deeps	deeps	dếp	dêps
speeedometer	speedometer	speeedometer	spêedometer
safflowwer	safflower	saflowwer	safflơwer
newsreeels	newsreels	newsreeels	newsrêels
pulpwoood	pulpwood	pulpwoood	pulpwôod
ladddie	laddie	ladddie	lađdie
trapdooor	trapdoor	trapdooor	trapdôor
seeesaww	seesaw	seesaww	sêesăw
fawwning	fawning	fawwning	făwning
deporteees	deportees	deporteees	deportêes
preceeeding	preceeding	preceeeding	precêeding
snowwshoes	snowshoes	snowwshoes	snơwshoes
legateee	legatee	legateee	legatêe
coons	coons	cốn	côns
chodoroww	chodorow	chodoroww	chodorơw
eddda	edda	eddda	eđda
fidddled	fiddled	fidddled	fiđdled
hideawway	hideaway	hideawway	hideăway
smallwoood	smallwood	smallwoood	smallwôod
zeeeland	zeeland	zeeeland	zêeland
gadddis	gaddis	gadddis	gađdis
spoools	spools	spoools	spôols
overshadowwing	overshadowing	overshadowwing	overshadơwing
brawwling	brawling	brawwling	brăwling
hollowwness	hollowness	hollowwness	hollơwness
feeeney	feeney	feeeney	fêeney
thuddding	thudding	thuddding	thuđding
sainthoood	sainthood	sainthoood	sainthôod
tepeee	tepee	tepe	tepêe
tepee	tepee	tepe	tepê
narrowwband	narrowband	narowwband	narrơwband
giveawway	giveaway	giveawway	giveăway
staterooom	stateroom	staterooom	staterôom
coffeeehouse	coffeehouse	cofeeehouse	coffêehouse
coffeees	coffees	cofeees	coffêes
brawwny	brawny	brawwny	brăwny
odddest	oddest	odddest	ođdest
taa	taa	tâ	tâ
choctawws	choctaws	choctawws	choctăws
johnstowwn	johnstown	johnstowwn	johnstơwn
jawwed	jawed	jawwed	jăwed
sorrowwing	sorrowing	sorowwing	sorrơwing
growwls	growls	growwls	grơwls
blooodiest	bloodiest	blooodiest	blôodiest
childhooods	childhoods	childhooods	childhôods
clowward	cloward	clowward	clơward
mcgheee	mcghee	mcgheee	mcghêe
mckeowwn	mckeown	mckeowwn	mckeơwn
megidddo	megiddo	megidddo	megiđdo
screee	scree	screee	scrêe
sneeers	sneers	sneeers	snêers
avoww	avow	avoww	avơw
hagerstowwn	hagerstown	hagerstowwn	hagerstơwn
slooops	sloops	slooops	slôops
stradddles	straddles	stradddles	strađdles
flowwmeter	flowmeter	flowwmeter	flơwmeter
elyseees	elysees	elyseees	elysêes
greeenough	greenough	greeenough	grêenough
aap	aap	âp	âp
privateeering	privateering	privateeering	privatêering
kapooor	kapoor	kapooor	kapôor
lndeeed	lndeed	lndeeed	lndêed
freeezers	freezers	freeezers	frêezers
couleee	coulee	couleee	coulêe
santeee	santee	santeee	santêe
blooor	bloor	blooor	blôor
hightowwer	hightower	hightowwer	hightơwer
kleeenex	kleenex	kleeenex	klêenex
jeeers	jeers	jeeers	jêers
staaaten	staaten	staaaten	stâaten
squawws	squaws	squawws	squăws
cudddling	cuddling	cudddling	cuđdling
feeedbacks	feedbacks	feeedbacks	fêedbacks
foootstep	footstep	foootstep	fôotstep
sharpshoooters	sharpshooters	sharpshoooters	sharpshôoters
cradddock	craddock	cradddock	crađdock
lidddy	liddy	lidddy	liđdy
leibowwitz	leibowitz	leibowwitz	leibơwitz
headddresses	headdresses	headddresses	heađdresses
crawwler	crawler	crawwler	crăwler
vrooom	vroom	vrooom	vrôom
chaffeee	chaffee	chafeee	chaffêe
chaffee	chaffee	chafee	chaffê
dupreee	dupree	dupreee	duprêe
freeest	freest	freeest	frêest
greeenbacks	greenbacks	greeenbacks	grêenbacks
stowwage	stowage	stowwage	stơwage
superviseee	supervisee	superviseee	supervisêe
hudddersfield	huddersfield	hudddersfield	huđdersfield
scrawwl	scrawl	scrawwl	scrăwl
fowwles	fowles	fowwles	fơwles
clowwning	clowning	clowwning	clơwning
alleee	allee	alleee	allêe
meyerbeeer	meyerbeer	meyerbeeer	meyerbêer
elbowwed	elbowed	elbowwed	elbơwed
blowwout	blowout	blowwout	blơwout
midddlebury	middlebury	midddlebury	miđdlebury
blooomberg	bloomberg	blooomberg	blôomberg
menomineee	menominee	menomineee	menominêe
plowwden	plowden	plowwden	plơwden
ecowwas	ecowas	ecowwas	ecơwas
overblowwn	overblown	overblowwn	overblơwn
steeelmaking	steelmaking	steeelmaking	stêelmaking
hornblowwer	hornblower	hornblowwer	hornblơwer
doon	doon	dôn	dôn
brawwls	brawls	brawwls	brăwls
milkweeed	milkweed	milkweeed	milkwêed
antifreeeze	antifreeze	antifreeeze	antifrêeze
brentwoood	brentwood	brentwoood	brentwôod
fallowws	fallows	fallowws	fallơws
mcafeee	mcafee	mcafeee	mcafêe
snowwmobile	snowmobile	snowwmobile	snơwmobile
crowwbar	crowbar	crowwbar	crơwbar
watchtowwer	watchtower	watchtowwer	watchtơwer
shreddding	shredding	shreddding	shređding
gidddiness	giddiness	gidddiness	giđdiness
lunchrooom	lunchroom	lunchrooom	lunchrôom
eeo	eeo	êo	êo
outgrowwths	outgrowths	outgrowwths	outgrơwths
bestowwal	bestowal	bestowwal	bestơwal
malloww	mallow	malloww	mallơw
ddd	ddd	dd	đd
cycloooxygenase	cyclooxygenase	cycloooxygenase	cyclôoxygenase
jubileees	jubilees	jubileees	jubilêes
kawwai	kawai	kawwai	kăwai
sidddons	siddons	sidddons	siđdons
linlithgoww	linlithgow	linlithgoww	linlithgơw
knowwhoww	knowhow	knowwhoww	knơwhơw
hedgeroww	hedgerow	hedgeroww	hedgerơw
grandeees	grandees	grandeees	grandêes
hayakawwa	hayakawa	hayakawwa	hayakăwa
pantalooons	pantaloons	pantalooons	pantalôons
showwmanship	showmanship	showwmanship	shơwmanship
haa	haa	hâ	hâ
macdowwell	macdowell	macdowwell	macdơwell
honeybeees	honeybees	honeybeees	honeybêes
speeedway	speedway	speeedway	spêedway
screeenplays	screenplays	screeenplays	scrêenplays
graaaff	graaff	graaaff	grâaff
prowwled	prowled	prowwled	prơwled
ddl	ddl	đl	đl
honeybeee	honeybee	honeybeee	honeybêe
typhooons	typhoons	typhooons	typhôons
overdrawwn	overdrawn	overdrawwn	overdrăwn
frisbeee	frisbee	frisbeee	frisbêe
adddressable	addressable	adddressable	ađdressable
showwcases	showcases	showwcases	shơwcases
anneee	annee	anneee	annêe
stoooges	stooges	stoooges	stôoges
overweeening	overweening	overweeening	overwêening
moores	moores	mốe	môres
mown	mown	mơn	mơn
allentowwn	allentown	allentowwn	allentơwn
stodddart	stoddart	stodddart	stođdart
riddder	ridder	riddder	riđder
shaaanxi	shaanxi	shaaanxi	shâanxi
uwe	uwe	ưe	ưe
veen	veen	vên	vên
cottonwooods	cottonwoods	cottonwooods	cottonwôods
woootton	wootton	uootton	wôotton
kurosawwa	kurosawa	kurosawwa	kurosăwa
staaatliche	staatliche	staaatliche	stâatliche
qadddafi	qaddafi	qadddafi	qađdafi
foootwork	footwork	foootwork	fôotwork
gleeeful	gleeful	gleeeful	glêeful
lakewoood	lakewood	lakewoood	lakewôod
coetzeee	coetzee	coetzeee	coetzêe
highspeeed	highspeed	highspeeed	highspêed
brawwn	brawn	brawwn	brăwn
dowson	dowson	dốn	dơson
koool	kool	koool	kôol
absenteees	absentees	absenteees	absentêes
freeestyle	freestyle	freeestyle	frêestyle
boor	boor	bổ	bôr
rapeseeed	rapeseed	rapeseeed	rapesêed
gridddle	griddle	gridddle	griđdle
henshaww	henshaw	henshaww	henshăw
eee	eee	ee	êe
deen	deen	dên	dên
nawaz	nawaz	na	năaz
idddm	iddm	idddm	iđdm
fellowwmen	fellowmen	fellowwmen	fellơwmen
kanawwha	kanawha	kanawwha	kanăwha
foootbridge	footbridge	foootbridge	fôotbridge
bylaww	bylaw	bylaww	bylăw
barrooom	barroom	barooom	barrôom
greeenbelt	greenbelt	greeenbelt	grêenbelt
ringwoood	ringwood	ringwoood	ringwôod
ooooooo	ooooo	oooooo	ôôôo
ooooo	ooooo	oooo	ôôo
sneeezed	sneezed	sneeezed	snêezed
noo	noo	nô	nô
spoooked	spooked	spoooked	spôoked
flowwrate	flowrate	flowwrate	flơwrate
flooodgates	floodgates	flooodgates	flôodgates
buccaneeer	buccaneer	buccaneeer	buccanêer
midddens	middens	midddens	miđdens
clawwson	clawson	clawwson	clăwson
koook	kook	koook	kôok
homeowwnership	homeownership	homeowwnership	homeơwnership
hudddleston	huddleston	hudddleston	huđdleston
goon	goon	gôn	gôn
aat	aat	ât	ât
marshmalloww	marshmallow	marshmalloww	marshmallơw
jeeez	jeez	jeeez	jêez
megawwatts	megawatts	megawwatts	megăwatts
aaas	aaas	aas	âas
peet	peet	pêt	pêt
kadddish	kaddish	kadddish	kađdish
zooologists	zoologists	zooologists	zôologists
grandddaughters	granddaughters	grandddaughters	granđdaughters
laidlaww	laidlaw	laidlaww	laidlăw
homerooom	homeroom	homerooom	homerôom
coors	coors	cố	côrs
snowwshoe	snowshoe	snowwshoe	snơwshoe
andreee	andree	andreee	andrêe
sideshoww	sideshow	sideshoww	sideshơw
hipaaa	hipaa	hipaaa	hipâa
mahmoood	mahmood	mahmoood	mahmôod
billowwed	billowed	billowwed	billơwed
horwoood	horwood	hỏood	horwôod
horwood	horwood	hỏod	horwôd
madddison	maddison	madddison	mađdison
catawwba	catawba	catwba	catăwba
dinwidddie	dinwiddie	dinwidddie	dinwiđdie
clowwes	clowes	clowwes	clơwes
heirloooms	heirlooms	heirloooms	heirlôoms
redrawwing	redrawing	redrawwing	redrăwing
kees	kees	kế	kês
greeenawway	greenaway	greeenawway	grêenăway
trow	trow	trơ	trơ
glowwering	glowering	glowwering	glơwering
renshaww	renshaw	renshaww	renshăw
nakagawwa	nakagawa	nakagawwa	nakagăwa
logboook	logbook	logboook	logbôok
geeek	geek	geeek	gêek
kozlowwski	kozlowski	kozlowwski	kozlơwski
janowwitz	janowitz	janowwitz	janơwitz
fooothill	foothill	fooothill	fôothill
divorceee	divorcee	divorceee	divorcêe
counseleee	counselee	counseleee	counselêe
unawwareness	unawareness	unawwareness	unăwareness
addders	adders	addders	ađders
coos	coos	cố	côs
snooop	snoop	snooop	snôop
cadddo	caddo	cadddo	cađdo
freeewheeeling	freewheeling	freeewheeeling	frêewhêeling
foreseeeability	foreseeability	foreseeeability	foresêeability
stylesheeet	stylesheet	stylesheeet	styleshêet
facedowwn	facedown	facedowwn	facedơwn
schooolcraft	schoolcraft	schooolcraft	schôolcraft
cathleeen	cathleen	cathleeen	cathlêen
sherbroooke	sherbrooke	sherbroooke	sherbrôoke
awwolowwo	awolowo	awolowwo	ăwolơwo
intraaabdominal	intraabdominal	intraaabdominal	intrâabdominal
croookes	crookes	croookes	crôokes
oilseeed	oilseed	oilseeed	oilsêed
shampooos	shampoos	shampooos	shampôos
mowat	mowat	mơat	mơat
braintreee	braintree	braintreee	braintrêe
snowwdon	snowdon	snowwdon	snơwdon
throwwers	throwers	throwwers	thrơwers
wildflowwer	wildflower	wildflowwer	wildflơwer
schoooldays	schooldays	schoooldays	schôoldays
zooot	zoot	zooot	zôot
crawwfish	crawfish	crawwfish	crăwfish
freeeland	freeland	freeeland	frêeland
grandddad	granddad	grandddad	granđdad
nidddm	niddm	nidddm	niđdm
haddden	hadden	haddden	hađden
marshmallowws	marshmallows	marshmallowws	marshmallơws
arrowwsmith	arrowsmith	arowwsmith	arrơwsmith
flaxseeed	flaxseed	flaxseeed	flaxsêed
jowwar	jowar	jowwar	jơwar
barstoww	barstow	barstoww	barstơw
pedddle	peddle	pedddle	peđdle
creeech	creech	creeech	crêech
throwwawway	throwaway	throwwawway	thrơwăway
fidddlers	fiddlers	fidddlers	fiđdlers
courtroooms	courtrooms	courtroooms	courtrôoms
windowwed	windowed	windowwed	windơwed
ragweeed	ragweed	ragweeed	ragwêed
scoooters	scooters	scoooters	scôoters
showwroooms	showrooms	showwroooms	shơwrôoms
blooomingdale	bloomingdale	blooomingdale	blôomingdale
onsloww	onslow	onsloww	onslơw
geeelong	geelong	geeelong	gêelong
spooor	spoor	spooor	spôor
sleeepwalking	sleepwalking	sleeepwalking	slêepwalking
preeening	preening	preeening	prêening
preschoooler	preschooler	preschoooler	preschôoler
windblowwn	windblown	windblowwn	windblơwn
queeenstowwn	queenstown	queenstowwn	quêenstơwn
streeetlights	streetlights	streeetlights	strêetlights
sewaneee	sewanee	sewaneee	sewanêe
browwsed	browsed	browwsed	brơwsed
profiteeers	profiteers	profiteeers	profitêers
overawwed	overawed	overawwed	overăwed
lefkowwitz	lefkowitz	lefkowwitz	lefkơwitz
liddded	lidded	liddded	liđded
betoook	betook	betoook	betôok
forsoooth	forsooth	forsoooth	forsôoth
padddocks	paddocks	padddocks	pađdocks
steeeples	steeples	steeeples	stêeples
baas	baas	bấ	bâs
powwwoww	powwow	powwoww	pơwwơw
powwow	powwow	powow	pơwơ
spooof	spoof	spooof	spôof
hudddling	huddling	hudddling	huđdling
greeenbaum	greenbaum	greeenbaum	grêenbaum
sidddha	siddha	sidddha	siđdha
fawwns	fawns	fawwns	făwns
coot	coot	côt	côt
dees	dees	dế	dês
fooodborne	foodborne	fooodborne	fôodborne
morgantowwn	morgantown	morgantowwn	morgantơwn
spottiswooode	spottiswoode	spottiswooode	spottiswôode
flooodlights	floodlights	flooodlights	flôodlights
schooolgirls	schoolgirls	schooolgirls	schôolgirls
storekeeepers	storekeepers	storekeeepers	storekêepers
sadddlebags	saddlebags	sadddlebags	sađdlebags
aws	aws	ắ	ăs
ingrowwth	ingrowth	ingrowwth	ingrơwth
interbreeeding	interbreeding	interbreeeding	interbrêeding
kanagawwa	kanagawa	kanagawwa	kanagăwa
feeedwater	feedwater	feeedwater	fêedwater
wooodhull	woodhull	uoodhull	wôodhull
supercoooled	supercooled	supercoooled	supercôoled
anneees	annees	anneees	annêes
coooperstowwn	cooperstown	cooperstowwn	côoperstơwn
karooo	karoo	karooo	karôo
threeeyear	threeyear	threeeyear	thrêeyear
codeboook	codebook	codeboook	codebôok
goateee	goatee	goateee	goatêe
gazetteeers	gazetteers	gazetteeers	gazettêers
boxwoood	boxwood	bõood	boxwôod
boxwood	boxwood	bõod	boxwôd
stowwell	stowell	stowwell	stơwell
wooodwinds	woodwinds	uoodwinds	wôodwinds
freeelancers	freelancers	freeelancers	frêelancers
hopwoood	hopwood	hopood	hopwôod
hopwood	hopwood	hopod	hopwôd
iglooo	igloo	iglooo	iglôo
mudddling	muddling	mudddling	muđdling
hapgoood	hapgood	hapgoood	hapgôod
boos	boos	bố	bôs
potawwatomi	potawatomi	potawwatomi	potăwatomi
greeenback	greenback	greeenback	grêenback
tdd	tdd	tđ	tđ
yoshikawwa	yoshikawa	yoshikawwa	yoshikăwa
maar	maar	mẩ	mâr
backdooor	backdoor	backdooor	backdôor
overshadowws	overshadows	overshadowws	overshadơws
greeenness	greenness	greeenness	grêenness
touchdowwns	touchdowns	touchdowwns	touchdơwns
adddi	addi	adddi	ađdi
baleeen	baleen	baleeen	balêen
fidddles	fiddles	fidddles	fiđdles
breastfeeed	breastfeed	breastfeeed	breastfêed
queers	queers	quế	quêrs
freeeborn	freeborn	freeeborn	frêeborn
charlottetowwn	charlottetown	charlottetowwn	charlottetơwn
wladyslaww	wladyslaw	wladyslaww	wladyslăw
snowwmelt	snowmelt	snowwmelt	snơwmelt
fawwkes	fawkes	fawwkes	făwkes
wooodard	woodard	uoodard	wôodard
gaa	gaa	gâ	gâ
ideees	idees	ideees	idêes
airpowwer	airpower	airpowwer	airpơwer
jawwbone	jawbone	jawwbone	jăwbone
underfloww	underflow	underfloww	underflơw
goalkeeeper	goalkeeper	goalkeeeper	goalkêeper
eboook	ebook	eboook	ebôok
tycooons	tycoons	tycooons	tycôons
bioengineeering	bioengineering	bioengineeering	bioenginêering
bronislaww	bronislaw	bronislaww	bronislăw
cadddie	caddie	cadddie	cađdie
volunteeerism	volunteerism	volunteeerism	voluntêerism
foootfalls	footfalls	foootfalls	fôotfalls
seabroook	seabrook	seabroook	seabrôok
letdowwn	letdown	letdowwn	letdơwn
storeroooms	storerooms	storeroooms	storerôoms
mudddied	muddied	mudddied	muđdied
kneeed	kneed	kneeed	knêed
feeelin	feelin	feeelin	fêelin
bulletprooof	bulletproof	bulletprooof	bulletprôof
buloww	bulow	buloww	bulơw
veers	veers	vế	vêrs
auctioneeers	auctioneers	auctioneeers	auctionêers
speeedier	speedier	speeedier	spêedier
brooomstick	broomstick	brooomstick	brôomstick
cloakrooom	cloakroom	cloakrooom	cloakrôom
lidddle	liddle	lidddle	liđdle
strooop	stroop	strooop	strôop
grahamstowwn	grahamstown	grahamstowwn	grahamstơwn
gabaaa	gabaa	gabaaa	gabâa
shawwneees	shawnees	shawwneees	shăwnêes
beeekeeeping	beekeeping	beekeeeping	bêekêeping
capetowwn	capetown	capetowwn	capetơwn
oozes	oozes	oé	ôzes
toots	toots	tốt	tôts
ichikawwa	ichikawa	ichikawwa	ichikăwa
goons	goons	gốn	gôns
hoots	hoots	hốt	hôts
feeedstocks	feedstocks	feeedstocks	fêedstocks
trelawwny	trelawny	trelawwny	trelăwny
seest	seest	sết	sêst
blooomers	bloomers	blooomers	blôomers
slaveowwners	slaveowners	slaveowwners	slaveơwners
hindooos	hindoos	hindooos	hindôos
schooolboooks	schoolbooks	schooolboooks	schôolbôoks
coffeeepot	coffeepot	cofeeepot	coffêepot
blooodbath	bloodbath	blooodbath	blôodbath
algaaas	algaas	algaaas	algâas
bedfellowws	bedfellows	bedfellowws	bedfellơws
grooote	groote	grooote	grôote
thurow	thurow	thuở	thurơ
allaaah	allaah	allaaah	allâah
littlewoood	littlewood	littlewoood	littlewôod
pedddled	peddled	pedddled	peđdled
creeeley	creeley	creeeley	crêeley
piscatawway	piscataway	piscatawway	piscatăway
awt	awt	ăt	ăt
kidddie	kiddie	kidddie	kiđdie
greeenhill	greenhill	greeenhill	grêenhill
woooldridge	wooldridge	uooldridge	wôoldridge
spermatozooon	spermatozoon	spermatozooon	spermatozôon
woools	wools	uools	wôols
wooodville	woodville	uoodville	wôodville
assigneees	assignees	asigneees	assignêes
pamphleteeer	pamphleteer	pamphleteeer	pamphletêer
attwoood	attwood	attwoood	attwôod
festooons	festoons	festooons	festôons
squawwk	squawk	squawwk	squăwk
workflowws	workflows	workflowws	workflơws
datafloww	dataflow	datafloww	dataflơw
amputeee	amputee	amputeee	amputêe
bestknowwn	bestknown	bestknowwn	bestknơwn
wooodlawwn	woodlawn	uoodlawwn	wôodlăwn
jooo	joo	jooo	jôo
drafteees	draftees	drafteees	draftêes
wooodsman	woodsman	uoodsman	wôodsman
cudddly	cuddly	cudddly	cuđdly
cranbroook	cranbrook	cranbroook	cranbrôok
crowwne	crowne	crowwne	crơwne
windowwing	windowing	windowwing	windơwing
oot	oot	ôt	ôt
raneee	ranee	raneee	ranêe
wooodcutter	woodcutter	uoodcutter	wôodcutter
reddd	redd	reddd	ređd
grameeen	grameen	grameeen	gramêen
fooodservice	foodservice	fooodservice	fôodservice
stokowwski	stokowski	stokowwski	stokơwski
droool	drool	droool	drôol
dooorkeeeper	doorkeeper	doorkeeeper	dôorkêeper
broadsheeet	broadsheet	broadsheeet	broadshêet
tarawwa	tarawa	tảwa	tarăwa
williamstowwn	williamstown	williamstowwn	williamstơwn
wooodhead	woodhead	uoodhead	wôodhead
spooonfuls	spoonfuls	spooonfuls	spôonfuls
croooned	crooned	croooned	crôoned
gooodfelloww	goodfellow	goodfelloww	gôodfellơw
flawwlessly	flawlessly	flawwlessly	flăwlessly
grandddadddy	granddaddy	grandddadddy	granđdađdy
penseees	pensees	pénees	pensêes
pensees	pensees	pénes	pensês
loons	loons	lốn	lôns
hows	hows	hớ	hơs
bassooons	bassoons	basooons	bassôons
acknowwledg	acknowledg	acknowwledg	acknơwledg
undertoww	undertow	undertoww	undertơw
wooodblock	woodblock	uoodblock	wôodblock
croooning	crooning	croooning	crôoning
coops	coops	cốp	côps
obligeee	obligee	obligeee	obligêe
kooopmans	koopmans	kooopmans	kôopmans
jowwl	jowl	jowwl	jơwl
jeeer	jeer	jeeer	jêer
dfeee	dfee	dfeee	dfêe
steeelworks	steelworks	steeelworks	stêelworks
budddhistic	buddhistic	budddhistic	buđdhistic
ideeen	ideen	ideeen	idêen
squawwking	squawking	squawwking	squăwking
snoook	snook	snoook	snôok
toon	toon	tôn	tôn
cabooose	caboose	cabooose	cabôose
sidddhanta	siddhanta	sidddhanta	siđdhanta
adddisonwesley	addisonwesley	adddisonwesley	ađdisonwesley
neer	neer	nể	nêr
feeeler	feeler	feeeler	fêeler
maynoooth	maynooth	maynoooth	maynôoth
thuddded	thudded	thuddded	thuđded
hooray	hooray	hôảy	hôray
browward	broward	browward	brơward
chooser	chooser	chổe	chôser
sightseeers	sightseers	sightseeers	sightsêers
ingaaas	ingaas	ingaaas	ingâas
graaaf	graaf	graaaf	grâaf
irrawwadddy	irrawaddy	irawwadddy	irrăwađdy
stowwing	stowing	stowwing	stơwing
cesspoool	cesspool	cesspoool	cesspôol
adddy	addy	adddy	ađdy
ameeer	ameer	ameeer	amêer
tows	tows	tớ	tơs
dallowway	dalloway	dallowway	dallơway
ridddance	riddance	ridddance	riđdance
vooorheees	voorhees	voorheees	vôorhêes
speee	spee	speee	spêe
coddd	codd	coddd	cođd
spawwns	spawns	spawwns	spăwns
predawwn	predawn	predawwn	predăwn
greeenock	greenock	greeenock	grêenock
bigfooot	bigfoot	bigfooot	bigfôot
incooordination	incoordination	incooordination	incôordination
jawworski	jaworski	jawworski	jăworski
megawwatt	megawatt	megawwatt	megăwatt
kooop	koop	kooop	kôop
lampooon	lampoon	lampooon	lampôon
addduces	adduces	addduces	ađduces
gowan	gowan	gơan	gơan
gamekeeeper	gamekeeper	gamekeeeper	gamekêeper
prooofreader	proofreader	prooofreader	prôofreader
pontooons	pontoons	pontooons	pontôons
freeemason	freemason	freeemason	frêemason
hazelwoood	hazelwood	hazelwoood	hazelwôod
kawwamura	kawamura	kawwamura	kăwamura
brokaww	brokaw	brokaww	brokăw
pawwneees	pawnees	pawneees	păwnêes
longwoood	longwood	longood	longwôod
longwood	longwood	longod	longwôd
shreee	shree	shreee	shrêe
preeestablished	preestablished	preeestablished	prêestablished
udddi	uddi	udddi	uđdi
feeebleminded	feebleminded	feeebleminded	fêebleminded
stoooge	stooge	stoooge	stôoge
poon	poon	pôn	pôn
schoooler	schooler	schoooler	schôoler
midnineteeenth	midnineteenth	midnineteeenth	midninetêenth
jeee	jee	jeee	jêe
steeedman	steedman	steeedman	stêedman
freeewill	freewill	freeewill	frêewill
okinawwan	okinawan	okinawwan	okinăwan
chattahooocheee	chattahoochee	chattahooocheee	chattahôochêe
lackawwanna	lackawanna	lackawwanna	lackăwanna
freeeboard	freeboard	freeeboard	frêeboard
ddp	ddp	đp	đp
followwings	followings	followwings	follơwings
schooolers	schoolers	schooolers	schôolers
glenwoood	glenwood	glenwoood	glenwôod
wallowwed	wallowed	wallowwed	wallơwed
boookkeeepers	bookkeepers	bookkeeepers	bôokkêepers
spooofing	spoofing	spooofing	spôofing
shakedowwn	shakedown	shakedowwn	shakedơwn
kawwakami	kawakami	kawwakami	kăwakami
unhoooked	unhooked	unhoooked	unhôoked
blooodline	bloodline	blooodline	blôodline
aau	aau	âu	âu
cockatooo	cockatoo	cockatooo	cockatôo
rabinoww	rabinow	rabinoww	rabinơw
widddowwson	widdowson	widdowwson	wiđdơwson
oxboww	oxbow	oxboww	oxbơw
wooodbine	woodbine	uoodbine	wôodbine
jowwls	jowls	jowwls	jơwls
aam	aam	âm	âm
crashaww	crashaw	crashaww	crashăw
toffeee	toffee	tofeee	toffêe
puppeteeer	puppeteer	puppeteeer	puppetêer
zooospores	zoospores	zooospores	zôospores
windowwpane	windowpane	windowwpane	windơwpane
subtreees	subtrees	subtreees	subtrêes
oort	oort	ổt	ôrt
earnshaww	earnshaw	earnshaww	earnshăw
backfloww	backflow	backfloww	backflơw
meech	meech	mêch	mêch
letterboook	letterbook	letterboook	letterbôok
rockwoood	rockwood	rockwoood	rockwôod
snowwballs	snowballs	snowwballs	snơwballs
reddden	redden	reddden	ređden
outlawwry	outlawry	outlawwry	outlăwry
gleeeson	gleeson	gleeeson	glêeson
investeee	investee	investeee	investêe
perroww	perrow	peroww	perrơw
truckeee	truckee	truckeee	truckêe
jawwahar	jawahar	jawwahar	jăwahar
foootlooose	footloose	foootlooose	fôotlôose
mccoook	mccook	mccoook	mccôok
schooolmate	schoolmate	schooolmate	schôolmate
threeesome	threesome	threeesome	thrêesome
kitagawwa	kitagawa	kitagawwa	kitagăwa
easterbroook	easterbrook	easterbroook	easterbrôok
supercoooling	supercooling	supercoooling	supercôoling
kanazawwa	kanazawa	kanazawwa	kanazăwa
munksgaaard	munksgaard	munksgaaard	munksgâard
browwed	browed	browwed	brơwed
arrowwrooot	arrowroot	arowwrooot	arrơwrôot
madddalena	maddalena	madddalena	mađdalena
palawwan	palawan	palawwan	palăwan
owi	owi	ơi	ơi
typeee	typee	typeee	typêe
growwnup	grownup	growwnup	grơwnup
gamoww	gamow	gamoww	gamơw
benboww	benbow	benboww	benbơw
jamaaat	jamaat	jamaaat	jamâat
knowwers	knowers	knowwers	knơwers
sheeeted	sheeted	sheeeted	shêeted
donneees	donnees	donneees	donnêes
bridgetowwn	bridgetown	bridgetowwn	bridgetơwn
disallowwing	disallowing	disallowwing	disallơwing
shirtsleeeves	shirtsleeves	shirtsleeeves	shirtslêeves
teddder	tedder	teddder	teđder
eet	eet	êt	êt
feeedlot	feedlot	feeedlot	fêedlot
leet	leet	lêt	lêt
hollowwing	hollowing	hollowwing	hollơwing
jeeeves	jeeves	jeeeves	jêeves
coffeeehouses	coffeehouses	cofeeehouses	coffêehouses
vdd	vdd	vđ	vđ
lowi	lowi	lơi	lơi
fedayeeen	fedayeen	fedayeeen	fedayêen
jarroww	jarrow	jarroww	jarrơw
abramowwitz	abramowitz	abramowwitz	abramơwitz
furukawwa	furukawa	furukawwa	furukăwa
wildfowwl	wildfowl	wildfowwl	wildfơwl
swoooning	swooning	suooning	swôoning
blooodhound	bloodhound	blooodhound	blôodhound
amputeees	amputees	amputeees	amputêes
buffooonery	buffoonery	bufooonery	buffôonery
gladddened	gladdened	gladddened	glađdened
fooodgrain	foodgrain	fooodgrain	fôodgrain
geeen	geen	geeen	gêen
superviseees	supervisees	superviseees	supervisêes
spleeens	spleens	spleeens	splêens
wooodchuck	woodchuck	uoodchuck	wôodchuck
arawwak	arawak	ảwak	arăwak
arawak	arawak	ẩk	arăak
racketeeers	racketeers	racketeeers	racketêers
shawwcross	shawcross	shawwcross	shăwcross
wooolens	woolens	uoolens	wôolens
zoooms	zooms	zoooms	zôoms
scooot	scoot	scooot	scôot
kickapooo	kickapoo	kickapooo	kickapôo
screeenwriters	screenwriters	screeenwriters	scrêenwriters
bukowwski	bukowski	bukowwski	bukơwski
overshoooting	overshooting	overshoooting	overshôoting
babyhoood	babyhood	babyhoood	babyhôod
committeeeman	committeeman	committeeeman	committêeman
headrooom	headroom	headrooom	headrôom
scoww	scow	scoww	scơw
showwcased	showcased	showwcased	shơwcased
highschoool	highschool	highschoool	highschôol
wolfowwitz	wolfowitz	wolfowwitz	wolfơwitz
nonfoood	nonfood	nònood	nonfôod
nonfood	nonfood	nònod	nonfôd
spaaatz	spaatz	spaaatz	spâatz
freeestone	freestone	freeestone	frêestone
flooodwaters	floodwaters	flooodwaters	flôodwaters
adddled	addled	adddled	ađdled
kooopman	koopman	kooopman	kôopman
yukawwa	yukawa	yukawwa	yukăwa
larrabeee	larrabee	larabeee	larrabêe
balloooned	ballooned	balloooned	ballôoned
noncoooperation	noncooperation	noncoooperation	noncôoperation
shoooed	shooed	shoooed	shôoed
blooodstains	bloodstains	blooodstains	blôodstains
shutdowwns	shutdowns	shutdowwns	shutdơwns
goof	goof	gồ	gôf
tarrytowwn	tarrytown	tarytowwn	tarrytơwn
beeekeeepers	beekeepers	beekeeepers	bêekêepers
garroww	garrow	garoww	garrơw
meow	meow	meơ	meơ
paar	paar	pẩ	pâr
youngbloood	youngblood	youngbloood	youngblôod
taboooed	tabooed	taboooed	tabôoed
cadddis	caddis	cadddis	cađdis
christiaaan	christiaan	christiaaan	christiâan
knowwl	knowl	knowwl	knơwl
beeps	beeps	bếp	bêps
starfleeet	starfleet	starfleeet	starflêet
boons	boons	bốn	bôns
fedddans	feddans	fedddans	feđdans
sadddler	saddler	sadddler	sađdler
prowwler	prowler	prowwler	prơwler
aberdeeenshire	aberdeenshire	aberdeeenshire	aberdêenshire
preeece	preece	preeece	prêece
scowwcroft	scowcroft	scowwcroft	scơwcroft
disempowwered	disempowered	disempowwered	disempơwered
noncoooperative	noncooperative	noncoooperative	noncôoperative
hosokawwa	hosokawa	hosokawwa	hosokăwa
elmwoood	elmwood	elmwoood	elmwôod
foootholds	footholds	foootholds	fôotholds
macaw	macaw	măc	macă
kenwoood	kenwood	kenwoood	kenwôod
legateees	legatees	legateees	legatêes
fanshawwe	fanshawe	fanshawwe	fanshăwe
kooontz	koontz	kooontz	kôontz
padddlers	paddlers	padddlers	pađdlers
woooley	wooley	uooley	wôoley
fleeecy	fleecy	fleeecy	flêecy
groooving	grooving	groooving	grôoving
freeeware	freeware	freeeware	frêeware
oom	oom	ôm	ôm
broooker	brooker	broooker	brôoker
sidddhi	siddhi	sidddhi	siđdhi
sodddy	soddy	sodddy	sođdy
flamsteeed	flamsteed	flamsteeed	flamstêed
godddammit	goddammit	godddammit	gođdammit
wooodley	woodley	uoodley	wôodley
feeelingly	feelingly	feeelingly	fêelingly
daewooo	daewoo	daewooo	daewôo
aaai	aai	aaai	âai
aai	aai	âi	âi
hangchoww	hangchow	hangchoww	hangchơw
wooolman	woolman	uoolman	wôolman
medawwar	medawar	medawwar	medăwar
gooodloooking	goodlooking	goodloooking	gôodlôoking
ruddders	rudders	ruddders	ruđders
graaal	graal	graaal	grâal
redddi	reddi	redddi	ređdi
blooodhounds	bloodhounds	blooodhounds	blôodhounds
schooolwide	schoolwide	schooolwide	schôolwide
gooodnoww	goodnow	goodnoww	gôodnơw
dooms	dooms	dốm	dôms
croooke	crooke	croooke	crôoke
shallowwly	shallowly	shallowwly	shallơwly
shoootout	shootout	shoootout	shôotout
wooodall	woodall	uoodall	wôodall
chickadeee	chickadee	chickadeee	chickadêe
eichengreeen	eichengreen	eichengreeen	eichengrêen
hinshaww	hinshaw	hinshawư	hinshăw
koww	kow	koww	kơw
gooodspeeed	goodspeed	goodspeeed	gôodspêed
veddder	vedder	veddder	veđder
jastroww	jastrow	jastroww	jastrơw
peeps	peeps	pếp	pêps
swoooned	swooned	suooned	swôoned
smokescreeen	smokescreen	smokescreeen	smokescrêen
buddded	budded	buddded	buđded
wooodburn	woodburn	uoodburn	wôodburn
adopteee	adoptee	adopteee	adoptêe
cuckooos	cuckoos	cuckooos	cuckôos
blooodlines	bloodlines	blooodlines	blôodlines
oor	oor	ổ	ôr
agreeeableness	agreeableness	agreeeableness	agrêeableness
hallowws	hallows	hallowws	hallơws
selfawwareness	selfawareness	selfawwareness	selfăwareness
spoooned	spooned	spoooned	spôoned
geeeta	geeta	geeeta	gêeta
showwpiece	showpiece	showwpiece	shơwpiece
bumblebeee	bumblebee	bumblebeee	bumblebêe
preschoools	preschools	preschoools	preschôols
gatewoood	gatewood	gatewoood	gatewôod
teem	teem	têm	têm
bresloww	breslow	bresloww	breslơw
basswoood	basswood	baswoood	basswôod
slaww	slaw	slaww	slăw
lwoww	lwow	lwoww	lwơw
dropdowwn	dropdown	dropdowwn	dropdơwn
saleeem	saleem	saleeem	salêem
daa	daa	dâ	dâ
wheeelbarrowws	wheelbarrows	wheelbarrowws	whêelbarrơws
pdd	pdd	pđ	pđ
awk	awk	ăk	ăk
katowwice	katowice	katowwice	katơwice
pudddling	puddling	pudddling	puđdling
veneered	veneered	venered	venêred
foootplate	footplate	foootplate	fôotplate
snoooze	snooze	snoooze	snôoze
spaaak	spaak	spaaak	spâak
wooodpile	woodpile	uoodpile	wôodpile
wooodshed	woodshed	uoodshed	wôodshed
stateowwned	stateowned	stateowwned	stateơwned
drawwstring	drawstring	drawwstring	drăwstring
heeft	heeft	hềt	hêft
hooch	hooch	hôch	hôch
browwner	browner	browwner	brơwner
gatekeeeping	gatekeeping	gatekeeeping	gatekêeping
midddles	middles	midddles	miđdles
carloww	carlow	carloww	carlơw
brawwley	brawley	brawwley	brăwley
aaaaaa	aaaa	aaaaa	âââ
aaaa	aaaa	aaa	ââ
embreee	embree	embreee	embrêe
medddlesome	meddlesome	medddlesome	međdlesome
steeelers	steelers	steeelers	stêelers
smooothest	smoothest	smooothest	smôothest
decreeeing	decreeing	decreeeing	decrêeing
woooten	wooten	uooten	wôoten
ceeecs	ceecs	ceeecs	cêecs
eer	eer	ể	êr
smoooths	smooths	smoooths	smôoths
chapboook	chapbook	chapboook	chapbôok
bdd	bdd	bđ	bđ
kareeem	kareem	kareeem	karêem
carrageeenan	carrageenan	carageeenan	carragêenan
tearooom	tearoom	tearooom	tearôom
bhawwan	bhawan	bhawwan	bhăwan
pillowwcase	pillowcase	pillowwcase	pillơwcase
committeeemen	committeemen	committeeemen	committêemen
mendeleeev	mendeleev	mendeleeev	mendelêev
schillebeeeckx	schillebeeckx	schillebeeeckx	schillebêeckx
beeetrooot	beetroot	beetrooot	bêetrôot
grabowwski	grabowski	grabowwski	grabơwski
snowwmobiles	snowmobiles	snowwmobiles	snơwmobiles
freeethinkers	freethinkers	freeethinkers	frêethinkers
maat	maat	mât	mât
timekeeeping	timekeeping	timekeeeping	timekêeping
kneeecap	kneecap	kneeecap	knêecap
grooovy	groovy	grooovy	grôovy
timekeeeper	timekeeper	timekeeeper	timekêeper
greeenhorn	greenhorn	greeenhorn	grêenhorn
likelihooods	likelihoods	likelihooods	likelihôods
edgewoood	edgewood	edgewoood	edgewôod
henslowwe	henslowe	henslowwe	henslơwe
homeschoooling	homeschooling	homeschoooling	homeschôoling
midddelburg	middelburg	midddelburg	miđdelburg
foootfall	footfall	foootfall	fôotfall
fellowwes	fellowes	fellowwes	fellơwes
awacs	awacs	ấc	ăacs
tomorrowws	tomorrows	tomorrowws	tomorrơws
drawwingrooom	drawingroom	drawwingrooom	drăwingrôom
chickasawws	chickasaws	chickasawws	chickasăws
cedaww	cedaw	cedaww	cedăw
wardlaww	wardlaw	wardlaww	wardlăw
laa	laa	lâ	lâ
minesweeepers	minesweepers	minesweeepers	mineswêepers
blakesleee	blakeslee	blakesleee	blakeslêe
holyroood	holyrood	holyroood	holyrôod
unloooked	unlooked	unloooked	unlôoked
drowwsily	drowsily	drowwsily	drơwsily
drooopy	droopy	drooopy	drôopy
oon	oon	ôn	ôn
wooodworkers	woodworkers	uoodworkers	wôodworkers
sleddding	sledding	sleddding	sleđding
zebedeee	zebedee	zebedeee	zebedêe
refloww	reflow	refloww	reflơw
fooolscap	foolscap	fooolscap	fôolscap
craww	craw	craww	crăw
malleee	mallee	malleee	mallêe
jazeeera	jazeera	jazeeera	jazêera
chainsaww	chainsaw	chainsaww	chainsăw
madddeningly	maddeningly	madddeningly	mađdeningly
halloww	hallow	halloww	hallơw
spoooks	spooks	spoooks	spôoks
overstreeet	overstreet	overstreeet	overstrêet
midddlesbrough	middlesbrough	midddlesbrough	miđdlesbrough
jawwa	jawa	jawwa	jăwa
micawwber	micawber	micawwber	micăwber
spotswoood	spotswood	spotswoood	spotswôod
odddball	oddball	odddball	ođdball
jonestowwn	jonestown	jonestowwn	jonestơwn
fooochoww	foochow	fooochoww	fôochơw
backrooom	backroom	backrooom	backrôom
pocketboooks	pocketbooks	pocketboooks	pocketbôoks
redboook	redbook	redboook	redbôok
benteeen	benteen	benteeen	bentêen
electrowweak	electroweak	electrowweak	electrơweak
fowwling	fowling	fowwling	fơwling
browwnfield	brownfield	browwnfield	brơwnfield
irredeeemable	irredeemable	iredeeemable	irredêemable
lowa	lowa	lơa	lơa
willowwy	willowy	willowwy	willơwy
miyazawwa	miyazawa	miyazawwa	miyazăwa
kidddush	kiddush	kidddush	kiđdush
midweeek	midweek	midweeek	midwêek
oost	oost	ốt	ôst
louww	louw	lơuw	loưw
addda	adda	addda	ađda
pamphleteeers	pamphleteers	pamphleteeers	pamphletêers
rickshawws	rickshaws	rickshawws	rickshăws
madddock	maddock	madddock	mađdock
scheeele	scheele	scheeele	schêele
deeedeee	deedee	deedeee	dêedêe
elizabethtowwn	elizabethtown	elizabethtowwn	elizabethtơwn
greeenhalgh	greenhalgh	greeenhalgh	grêenhalgh
windowwpanes	windowpanes	windowwpanes	windơwpanes
roddd	rodd	roddd	rođd
steeeping	steeping	steeeping	stêeping
kiddded	kidded	kiddded	kiđded
streeetlight	streetlight	streeetlight	strêetlight
kawwaguchi	kawaguchi	kawwaguchi	kăwaguchi
jooos	joos	jooos	jôos
knowwland	knowland	knowwland	knơwland
racketeeer	racketeer	racketeeer	racketêer
kidddies	kiddies	kidddies	kiđdies
bedddoes	beddoes	bedddoes	beđdoes
betweeens	betweens	betweeens	betwêens
creees	crees	creees	crêes
freeeholder	freeholder	freeeholder	frêeholder
showwtime	showtime	showwtime	shơwtime
clubfooot	clubfoot	clubfooot	clubfôot
speddding	spedding	speddding	speđding
knowwe	knowe	knowwe	knơwe
mdd	mdd	mđ	mđ
hiaa	hiaa	hiâ	hiâ
kathiawwar	kathiawar	kathiawwar	kathiăwar
sneeed	sneed	sneeed	snêed
threeefourths	threefourths	threeefourths	thrêefourths
jooost	joost	jooost	jôost
beeekeeeper	beekeeper	beekeeeper	bêekêeper
crawwlers	crawlers	crawwlers	crăwlers
ftaaa	ftaa	ftaaa	ftâa
haddde	hadde	haddde	hađde
jezreeel	jezreel	jezreeel	jezrêel
schooolmistress	schoolmistress	schooolmistress	schôolmistress
hacksaww	hacksaw	hacksaww	hacksăw
preeexistent	preexistent	preeexistent	prêexistent
rockawway	rockaway	rockawway	rockăway
sutteee	suttee	sutteee	suttêe
geeez	geez	geeez	gêez
disallowws	disallows	disallowws	disallơws
inviteees	invitees	inviteees	invitêes
grotowwski	grotowski	grotowwski	grotơwski
blowwdowwn	blowdown	blowwdowwn	blơwdơwn
dureee	duree	dủee	durêe
duree	duree	dủee	durê
rhonddda	rhondda	rhonddda	rhonđda
tomahawwks	tomahawks	tomahawwks	tomahăwks
selfknowwledge	selfknowledge	selfknowwledge	selfknơwledge
holbroooke	holbrooke	holbroooke	holbrôoke
fukuzawwa	fukuzawa	fukuzawwa	fukuzăwa
towson	towson	tốn	tơson
teems	teems	tếm	têms
foootballer	footballer	foootballer	fôotballer
nonpooor	nonpoor	nonpooor	nonpôor
gooodwoood	goodwood	goodwoood	gôodwôod
kidddo	kiddo	kidddo	kiđdo
factboook	factbook	factboook	factbôok
ingrowwn	ingrown	ingrowwn	ingrơwn
raaf	raaf	rầ	râf
snooopy	snoopy	snooopy	snôopy
crowwfooot	crowfoot	crowwfooot	crơwfôot
metaaanalysis	metaanalysis	metaaanalysis	metâanalysis
kagawwa	kagawa	kagawwa	kagăwa
swooops	swoops	suoops	swôops
swoops	swoops	suốp	swôps
greeely	greely	greeely	grêely
sadddling	saddling	sadddling	sađdling
passboook	passbook	pasboook	passbôok
skeeet	skeet	skeeet	skêet
scrimshaww	scrimshaw	scrimshaww	scrimshăw
nodddings	noddings	nodddings	nođdings
squawwked	squawked	squawwked	squăwked
sneeezes	sneezes	sneeezes	snêezes
threeepenny	threepenny	threeepenny	thrêepenny
godowwns	godowns	godowwns	godơwns
knockdowwn	knockdown	knockdowwn	knockdơwn
andreeev	andreev	andreeev	andrêev
crossbreeeding	crossbreeding	crossbreeeding	crossbrêeding
cowpox	cowpox	cỗp	cơpox
sickrooom	sickroom	sickrooom	sickrôom
wydawwnictwo	wydawnictwo	wydawwnictwo	wydăwnictwo
medddled	meddled	medddled	međdled
bazoooka	bazooka	bazoooka	bazôoka
kawwabata	kawabata	kawwabata	kăwabata
gadddi	gaddi	gadddi	gađdi
mackinaww	mackinaw	mackinaww	mackinăw
tablespooonful	tablespoonful	tablespooonful	tablespôonful
hoon	hoon	hôn	hôn
mukerjeee	mukerjee	mukerjeee	mukerjêe
kingstowwn	kingstown	kingstowwn	kingstơwn
greeenbrier	greenbrier	greeenbrier	grêenbrier
evacueee	evacuee	evacueee	evacuêe
subflooor	subfloor	subflooor	subflôor
greeenlanders	greenlanders	greeenlanders	grêenlanders
fleeeces	fleeces	fleeeces	flêeces
threeescore	threescore	threeescore	thrêescore
shoootin	shootin	shoootin	shôotin
edddying	eddying	edddying	eđdying
unadddressed	unaddressed	unadddressed	unađdressed
arresteee	arrestee	aresteee	arrestêe
shopflooor	shopfloor	shopflooor	shopflôor
prophethoood	prophethood	prophethoood	prophethôod
intraaarticular	intraarticular	intraaarticular	intrâarticular
jamboreee	jamboree	jamboreee	jamborêe
grandeee	grandee	grandeee	grandêe
ddi	ddi	đi	đi
truebloood	trueblood	truebloood	trueblôod
ogeee	ogee	ogeee	ogêe
sidddiqui	siddiqui	sidddiqui	siđdiqui
wooollcott	woollcott	uoollcott	wôollcott
skooog	skoog	skooog	skôog
songboook	songbook	songboook	songbôok
izaaak	izaak	izaaak	izâak
codddled	coddled	codddled	cođdled
wooollens	woollens	uoollens	wôollens
suhrawwardy	suhrawardy	suhrawwardy	suhrăwardy
piltdowwn	piltdown	piltdowwn	piltdơwn
mazdooor	mazdoor	mazdooor	mazdôor
bleeecker	bleecker	bleeecker	blêecker
helpeee	helpee	helpeee	helpêe
griddded	gridded	griddded	griđded
booz	booz	bo	bôz
catherwoood	catherwood	catherwoood	catherwôod
diningrooom	diningroom	diningrooom	diningrôom
schooolhouses	schoolhouses	schooolhouses	schôolhouses
fallowwing	fallowing	fallowwing	fallơwing
southwoood	southwood	southwoood	southwôod
raa	raa	râ	râ
jaaar	jaar	jaaar	jâar
awn	awn	ăn	ăn
skeeeter	skeeter	skeeeter	skêeter
arakawwa	arakawa	arakawwa	arakăwa
elyseee	elysee	elyseee	elysêe
steeeplechase	steeplechase	steeeplechase	stêeplechase
speeedboat	speedboat	speeedboat	spêedboat
hooft	hooft	hồt	hôft
duveeen	duveen	duveeen	duvêen
greeenham	greenham	greeenham	grêenham
chickadeees	chickadees	chickadeees	chickadêes
dungareees	dungarees	dungareees	dungarêes
koootenay	kootenay	koootenay	kôotenay
patenteees	patentees	patenteees	patentêes
inglewoood	inglewood	inglewoood	inglewôod
eets	eets	ết	êts
mitteee	mittee	mitteee	mittêe
showwcasing	showcasing	showwcasing	shơwcasing
volksraaad	volksraad	volksraaad	volksrâad
sheeena	sheena	sheeena	shêena
odddi	oddi	odddi	ođdi
snoooker	snooker	snoooker	snôoker
jaffeee	jaffee	jaffeee	jaffêe
swallowwtail	swallowtail	swallowwtail	swallơwtail
poof	poof	pồ	pôf
epizoootic	epizootic	epizoootic	epizôotic
superaddded	superadded	superaddded	superađded
ravenswoood	ravenswood	ravenswoood	ravenswôod
clowwnish	clownish	clowwnish	clơwnish
disempowwerment	disempowerment	disempowwerment	disempơwerment
minoww	minow	minoww	minơw
packwoood	packwood	packwoood	packwôod
screeed	screed	screeed	scrêed
cashfloww	cashflow	cashfloww	cashflơw
shreddder	shredder	shreddder	shređder
oaa	oaa	oâ	oâ
steeere	steere	steeere	stêere
blowwpipe	blowpipe	blowwpipe	blơwpipe
nishikawwa	nishikawa	nishikawwa	nishikăwa
tseee	tsee	tseee	tsêe
kaww	kaw	kaww	kăw
lawwnmowwer	lawnmower	lawnmowwer	lăwnmơwer
zooomorphic	zoomorphic	zooomorphic	zôomorphic
browwnmiller	brownmiller	browwnmiller	brơwnmiller
codddling	coddling	codddling	cođdling
steeersman	steersman	steeersman	stêersman
bumblebeees	bumblebees	bumblebeees	bumblebêes
papeeete	papeete	papeeete	papêete
steeelwork	steelwork	steeelwork	stêelwork
ahluwwalia	ahluwalia	ahluwwalia	ahlưwalia
greeediness	greediness	greeediness	grêediness
staaatsbibliothek	staatsbibliothek	staaatsbibliothek	stâatsbibliothek
thaws	thaws	thắ	thăs
kawwashima	kawashima	kawwashima	kăwashima
kuwwaitis	kuwaitis	kuwwaitis	kưwaitis
virchowws	virchows	virchowws	virchơws
harrowws	harrows	harowws	harrơws
twowway	twoway	twowway	twơway
jankowwski	jankowski	jankowwski	jankơwski
levittowwn	levittown	levittowwn	levittơwn
geeeks	geeks	geeeks	gêeks
stringfelloww	stringfellow	stringfelloww	stringfellơw
smithereeens	smithereens	smithereeens	smitherêens
mees	mees	mế	mês
haart	haart	hẩt	hârt
untroddden	untrodden	untroddden	untrođden
pingreee	pingree	pingreee	pingrêe
maumeee	maumee	maumeee	maumêe
arrowwed	arrowed	arowwed	arrơwed
beseeeched	beseeched	béeeched	besêeched
beseeched	beseeched	béeched	besêched
mccawwley	mccawley	mccawwley	mccăwley
lowwdowwn	lowdown	lowdowwn	lơwdơwn
tanglewoood	tanglewood	tanglewoood	tanglewôod
winnowwed	winnowed	winnowwed	winnơwed
stockrooom	stockroom	stockrooom	stockrôom
pinewoood	pinewood	pinewoood	pinewôod
overawwe	overawe	overawwe	overăwe
geeert	geert	geeert	gêert
snowwstorms	snowstorms	snowwstorms	snơwstorms
bodddy	boddy	bodddy	bođdy
faroooq	farooq	faroooq	farôoq
elbowwing	elbowing	elbowwing	elbơwing
tyreee	tyree	tỷee	tyrêe
tyree	tyree	tỷee	tyrê
sheeepdog	sheepdog	sheeepdog	shêepdog
breeezed	breezed	breeezed	brêezed
feeer	feer	feeer	fêer
owa	owa	ơa	ơa
bradleee	bradlee	bradleee	bradlêe
freeethinker	freethinker	freeethinker	frêethinker
counterfloww	counterflow	counterfloww	counterflơw
divorceees	divorcees	divorceees	divorcêes
eero	eero	ểo	êro
soundprooof	soundproof	soundprooof	soundprôof
oddder	odder	oddder	ođder
feeedstuffs	feedstuffs	feeedstuffs	fêedstuffs
disavowwing	disavowing	disavowwing	disavơwing
wooogie	woogie	uoogie	wôogie
nanowwires	nanowires	nanowwires	nanơwires
addducing	adducing	addducing	ađducing
gawk	gawk	găk	găk
staaal	staal	staaal	stâal
sokoloww	sokolow	sokoloww	sokolơw
unbeknowwn	unbeknown	unbeknowwn	unbeknơwn
troubleshoooter	troubleshooter	troubleshoooter	troubleshôoter
liebowwitz	liebowitz	liebowwitz	liebơwitz
freeewriting	freewriting	freeewriting	frêewriting
guffaww	guffaw	gufaww	guffăw
eboooks	ebooks	eboooks	ebôoks
screeenwriting	screenwriting	screeenwriting	scrêenwriting
cooch	cooch	côch	côch
kaaaba	kaaba	kaaaba	kâaba
plowwshares	plowshares	plowwshares	plơwshares
pledgeee	pledgee	pledgeee	pledgêe
cowwperwoood	cowperwood	cowperwoood	cơwperwôod
showwplace	showplace	showwplace	shơwplace
maddding	madding	maddding	mađding
goshawwk	goshawk	goshawwk	goshăwk
braidwoood	braidwood	braidwoood	braidwôod
whistleblowwer	whistleblower	whistleblowwer	whistleblơwer
bitterrooot	bitterroot	bitterrooot	bitterrôot
foootballers	footballers	foootballers	fôotballers
aronowwitz	aronowitz	aronowwitz	aronơwitz
waww	waw	wawư	wăw
scuddding	scudding	scuddding	scuđding
gliddden	glidden	gliddden	gliđden
codddington	coddington	codddington	cođdington
sheddd	shedd	sheddd	sheđd
snowwboarding	snowboarding	snowwboarding	snơwboarding
bronowwski	bronowski	bronowwski	bronơwski
coreldraww	coreldraw	coreldraww	coreldrăw
moookerjeee	mookerjee	mookerjeee	môokerjêe
orooonoko	oroonoko	ỏoonoko	orôonoko
oroonoko	oroonoko	ỏonoko	orônoko
harlowwe	harlowe	harlowwe	harlơwe
hooodooo	hoodoo	hoodooo	hôodôo
trincomaleee	trincomalee	trincomaleee	trincomalêe
breeese	breese	breeese	brêese
greeenleee	greenlee	greeenleee	grêenlêe
stepladdder	stepladder	stepladdder	steplađder
ashdowwn	ashdown	ashdowwn	ashdơwn
zooologie	zoologie	zooologie	zôologie
tadddeo	taddeo	tadddeo	tađdeo
snowwdrifts	snowdrifts	snowwdrifts	snơwdrifts
crossbowws	crossbows	crossbowws	crossbơws
dunawway	dunaway	dunawway	dunăway
woooly	wooly	uooly	wôoly
foootwall	footwall	foootwall	fôotwall
coleslaww	coleslaw	coleslaww	coleslăw
deviseee	devisee	deviseee	devisêe
ridddling	riddling	ridddling	riđdling
slideshoww	slideshow	slideshoww	slideshơw
matineees	matinees	matineees	matinêes
assembleee	assemblee	asembleee	assemblêe
gitloww	gitlow	gitloww	gitlơw
awwa	awwa	awa	ăwa
freeeboooters	freebooters	freeeboooters	frêebôoters
uddders	udders	uddders	uđders
sharpshoooter	sharpshooter	sharpshoooter	sharpshôoter
greeenacre	greenacre	greeenacre	grêenacre
spreees	sprees	spreees	sprêes
flowwsheeet	flowsheet	flowwsheeet	flơwshêet
midddlebroook	middlebrook	midddlebroook	miđdlebrôok
tarroww	tarrow	taroww	tarrơw
oooh	oooh	ooh	ôoh
greeenwilloww	greenwillow	greeenwilloww	grêenwillơw
snowwpack	snowpack	snowwpack	snơwpack
buffooons	buffoons	bufooons	buffôons
kantorowwicz	kantorowicz	kantorowwicz	kantorơwicz
threeepence	threepence	threeepence	thrêepence
blackhawwk	blackhawk	blackhawwk	blackhăwk
followweth	followeth	followweth	follơweth
retoooling	retooling	retoooling	retôoling
knowwledgeably	knowledgeably	knowwledgeably	knơwledgeably
streeetwise	streetwise	streeetwise	strêetwise
hullabalooo	hullabaloo	hullabalooo	hullabalôo
bungeee	bungee	bungeee	bungêe
pauw	pauw	paư	paư
fenugreeek	fenugreek	fenugreeek	fenugrêek
puppeteeers	puppeteers	puppeteeers	puppetêers
zeeeb	zeeb	zeeeb	zêeb
chowk	chowk	chơk	chơk
yellowwknife	yellowknife	yellowwknife	yellơwknife
bleeeder	bleeder	bleeeder	blêeder
freeese	freese	freeese	frêese
negligeee	negligee	negligeee	negligêe
macqueeen	macqueen	macqueeen	macquêen
wooodcarving	woodcarving	uoodcarving	wôodcarving
preeempts	preempts	preeempts	prêempts
harrassowwitz	harrassowitz	harrassowwitz	harrassơwitz
linwoood	linwood	linwoood	linwôod
lampoooned	lampooned	lampoooned	lampôoned
overpowwers	overpowers	overpowwers	overpơwers
mcnameee	mcnamee	mcnameee	mcnamêe
raintreee	raintree	raintreee	raintrêe
flowwmeters	flowmeters	flowwmeters	flơwmeters
victimhoood	victimhood	victimhoood	victimhôod
undercoooling	undercooling	undercoooling	undercôoling
goddden	godden	goddden	gođden
velveteeen	velveteen	velveteeen	velvetêen
cadddies	caddies	cadddies	cađdies
meddd	medd	meddd	međd
saybroook	saybrook	saybroook	saybrôok
boookworm	bookworm	boởkom	bôokworm
scheeel	scheel	scheeel	schêel
spoooning	spooning	spoooning	spôoning
preeen	preen	preeen	prêen
unpeeeled	unpeeled	unpeeeled	unpêeled
rudddick	ruddick	rudddick	ruđdick
prooofed	proofed	prooofed	prôofed
browwnlie	brownlie	browwnlie	brơwnlie
allowway	alloway	allowway	allơway
patteee	pattee	patteee	pattêe
mellowwing	mellowing	mellowwing	mellơwing
altooona	altoona	altooona	altôona
showwmen	showmen	showwmen	shơwmen
taprooot	taproot	taprooot	taprôot
mcneeely	mcneely	mcneeely	mcnêely
smooothie	smoothie	smooothie	smôothie
massawwa	massawa	masawwa	massăwa
looses	looses	lốe	lôses
chapboooks	chapbooks	chapboooks	chapbôoks
khoo	khoo	khô	khô
drawwling	drawling	drawwling	drăwling
snoooty	snooty	snoooty	snôoty
feeebler	feebler	feeebler	fêebler
pulldowwn	pulldown	pulldowwn	pulldơwn
guffawwed	guffawed	gufawwed	guffăwed
adriaaan	adriaan	adriaaan	adriâan
wittkowwer	wittkower	wittkowwer	wittkơwer
pudddled	puddled	pudddled	puđdled
kamlooops	kamloops	kamlooops	kamlôops
fowwle	fowle	fowwle	fơwle
degrooot	degroot	degrooot	degrôot
addderley	adderley	addderley	ađderley
proudfooot	proudfoot	proudfooot	proudfôot
howson	howson	hốn	hơson
yellowwfin	yellowfin	yellowwfin	yellơwfin
riebeeeck	riebeeck	riebeeeck	riebêeck
sadddlebag	saddlebag	sadddlebag	sađdlebag
smalltowwn	smalltown	smalltowwn	smalltơwn
foredooomed	foredoomed	foredooomed	foredôomed
wuthnoww	wuthnow	wuthnoww	wuthnơw
greeenberger	greenberger	greeenberger	grêenberger
bowra	bowra	bởa	bơra
croookedly	crookedly	croookedly	crôokedly
hadddington	haddington	hadddington	hađdington
greeenlandic	greenlandic	greeenlandic	grêenlandic
sleeeman	sleeman	sleeeman	slêeman
bleeeker	bleeker	bleeeker	blêeker
roundwoood	roundwood	roundwoood	roundwôod
calderwoood	calderwood	calderwoood	calderwôod
sooochoww	soochow	soochoww	sôochơw
snowwbound	snowbound	snowwbound	snơwbound
sprawwls	sprawls	sprawwls	sprăwls
ballroooms	ballrooms	ballroooms	ballrôoms
markdowwns	markdowns	markdowwns	markdơwns
yahooos	yahoos	yahooos	yahôos
okeeechobeee	okeechobee	okeeechobeee	okêechobêe
staww	staw	staww	stăw
watzlawwick	watzlawick	watzlawwick	watzlăwick
kolakowwski	kolakowski	kolakowwski	kolakơwski
millbroook	millbrook	millbroook	millbrôok
sacajawwea	sacajawea	sacajawwea	sacajăwea
kooon	koon	kooon	kôon
atleee	atlee	atleee	atlêe
newsroooms	newsrooms	newsroooms	newsrôoms
slowwdowwns	slowdowns	slowwdowwns	slơwdơwns
creeer	creer	creeer	crêer
jaaap	jaap	jaaap	jâap
irredeeemably	irredeemably	iredeeemably	irredêemably
vereeeniging	vereeniging	vẻeeniging	verêeniging
bleeek	bleek	bleeek	blêek
mcdowwall	mcdowall	mcdowwall	mcdơwall
bobroww	bobrow	bobroww	bobrơw
lebowwitz	lebowitz	lebowwitz	lebơwitz
cudddy	cuddy	cudddy	cuđdy
disowwning	disowning	diówning	disơwning
offscreeen	offscreen	ofscreeen	offscrêen
wilamowwitz	wilamowitz	wilamowwitz	wilamơwitz
flooorboard	floorboard	flooorboard	flôorboard
storyboooks	storybooks	storyboooks	storybôoks
menteee	mentee	menteee	mentêe
quidddity	quiddity	quidddity	quiđdity
pinwheeel	pinwheel	pinwheeel	pinwhêel
fluddd	fludd	fluddd	fluđd
addductors	adductors	addductors	ađductors
greeenschist	greenschist	greeenschist	grêenschist
squeeegeee	squeegee	squeeegeee	squêegêe
counteee	countee	counteee	countêe
ludddites	luddites	ludddites	luđdites
oooooooooooo	oooooooo	ooooooooooo	ôôôôôô
oooooooo	oooooooo	ooooooo	ôôôô
camerooonian	cameroonian	camerooonian	camerôonian
bybeee	bybee	bybeee	bybêe
daan	daan	dân	dân
speeedwell	speedwell	speeedwell	spêedwell
inwoood	inwood	inwoood	inwôod
intraaarterial	intraarterial	intraaarterial	intrâarterial
dhoww	dhow	dhoww	dhơw
sketchboooks	sketchbooks	sketchboooks	sketchbôoks
giveawways	giveaways	giveawways	giveăways
doctoroww	doctorow	doctoroww	doctorơw
peoplehoood	peoplehood	peoplehoood	peoplehôod
kedddie	keddie	kedddie	keđdie
teeepeee	teepee	teepeee	têepêe
outgrowwing	outgrowing	outgrowwing	outgrơwing
bollywoood	bollywood	bollywoood	bollywôod
fdd	fdd	fđ	fđ
colebroooke	colebrooke	colebroooke	colebrôoke
feeedlots	feedlots	feeedlots	fêedlots
wooodcutters	woodcutters	uoodcutters	wôodcutters
steeevens	steevens	steeevens	stêevens
leboww	lebow	leboww	lebơw
freeebsd	freebsd	freeebsd	frêebsd
sradddha	sraddha	sradddha	srađdha
roon	roon	rôn	rôn
unlikelihoood	unlikelihood	unlikelihoood	unlikelihôod
glowwingly	glowingly	glowwingly	glơwingly
wooodlot	woodlot	uoodlot	wôodlot
hedddle	heddle	hedddle	heđdle
tumbledowwn	tumbledown	tumbledowwn	tumbledơwn
traleee	tralee	traleee	tralêe
greeengrocer	greengrocer	greeengrocer	grêengrocer
freeeform	freeform	freeeform	frêeform
shantytowwn	shantytown	shantytowwn	shantytơwn
odddness	oddness	odddness	ođdness
knooop	knoop	knooop	knôop
depauww	depauw	depauww	depaưw
bhooodan	bhoodan	bhooodan	bhôodan
bradddon	braddon	bradddon	brađdon
shantytowwns	shantytowns	shantytowwns	shantytơwns
broadsheeets	broadsheets	broadsheeets	broadshêets
freeethinking	freethinking	freeethinking	frêethinking
macaws	macaws	mắc	macăs
logwoood	logwood	logwoood	logwôod
bengaleee	bengalee	bengaleee	bengalêe
nightgowwns	nightgowns	nightgowwns	nightgơwns
browwnstein	brownstein	browwnstein	brơwnstein
zoook	zook	zoook	zôok
wooodsmen	woodsmen	uoodsmen	wôodsmen
brainpowwer	brainpower	brainpowwer	brainpơwer
interbreeed	interbreed	interbreeed	interbrêed
dershowwitz	dershowitz	dershowwitz	dershơwitz
wallflowwer	wallflower	wallflowwer	wallflơwer
blowwup	blowup	blowwup	blơwup
wooozy	woozy	uoozy	wôozy
fleeeced	fleeced	fleeeced	flêeced
landseeer	landseer	landseeer	landsêer
overthrowws	overthrows	overthrowws	overthrơws
crossfloww	crossflow	crossfloww	crossflơw
umpteeenth	umpteenth	umpteeenth	umptêenth
dombrowwski	dombrowski	dombrowwski	dombrơwski
nees	nees	nế	nês
usaaf	usaaf	uầ	usâf
overfeeeding	overfeeding	overfeeeding	overfêeding
shallowwest	shallowest	shallowwest	shallơwest
mckeeever	mckeever	mckeeever	mckêever
screeenshot	screenshot	screeenshot	scrêenshot
sugawwara	sugawara	sugawwara	sugăwara
flowwerbeds	flowerbeds	flowwerbeds	flơwerbeds
mccowwn	mccown	mccowwn	mccơwn
spoooling	spooling	spoooling	spôoling
seafooods	seafoods	seafooods	seafôods
pritheee	prithee	pritheee	prithêe
fraaassen	fraassen	fraaassen	frâassen
wooolgar	woolgar	uoolgar	wôolgar
vreeeland	vreeland	vreeeland	vrêeland
fellowwman	fellowman	fellowwman	fellơwman
showwbiz	showbiz	showwbiz	shơwbiz
watchtowwers	watchtowers	watchtowwers	watchtơwers
wooodcraft	woodcraft	uoodcraft	wôodcraft
pillowwcases	pillowcases	pillowwcases	pillơwcases
barnouww	barnouw	barnouww	barnoưw
broadmooor	broadmoor	broadmooor	broadmôor
livingrooom	livingroom	livingrooom	livingrôom
wooodlots	woodlots	uoodlots	wôodlots
inbetweeen	inbetween	inbetweeen	inbetwêen
jawwline	jawline	jawwline	jăwline
hounsloww	hounslow	hounsloww	hounslơw
cloooney	clooney	cloooney	clôoney
stateroooms	staterooms	stateroooms	staterôoms
flooodwater	floodwater	flooodwater	flôodwater
wooodring	woodring	uoodring	wôodring
powis	powis	pới	pơis
macgowwan	macgowan	macgowwan	macgơwan
goreee	goree	gỏee	gorêe
lyddda	lydda	lyddda	lyđda
inviteee	invitee	inviteee	invitêe
breeedlove	breedlove	breeedlove	brêedlove
uncrowwded	uncrowded	uncrowwded	uncrơwded
kaaa	kaa	kaaa	kâa
commandeeer	commandeer	commandeeer	commandêer
waterpowwer	waterpower	waterpowwer	waterpơwer
studdding	studding	studdding	stuđding
harrowwed	harrowed	harowwed	harrơwed
billowwy	billowy	billowwy	billơwy
gnawws	gnaws	gnawws	gnăws
warshaww	warshaw	warshaww	warshăw
sleeepwalker	sleepwalker	sleeepwalker	slêepwalker
kooos	koos	kooos	kôos
aways	aways	ấy	ăays
lowwbroww	lowbrow	lowbroww	lơwbrơw
yoknapatawwpha	yoknapatawpha	yoknapatawwpha	yoknapatăwpha
crowwninshield	crowninshield	crowwninshield	crơwninshield
addducted	adducted	addducted	ađducted
mclawws	mclaws	mclawws	mclăws
overcoooked	overcooked	overcoooked	overcôoked
steeeling	steeling	steeeling	stêeling
emceee	emcee	emceee	emcêe
ondaaatje	ondaatje	ondaaatje	ondâatje
peleee	pelee	peleee	pelêe
flowwerpot	flowerpot	flowwerpot	flơwerpot
frawwley	frawley	frawwley	frăwley
disavowws	disavows	disavowws	disavơws
pillowwed	pillowed	pillowwed	pillơwed
coots	coots	cốt	côts
yellowwtail	yellowtail	yellowwtail	yellơwtail
quickdraww	quickdraw	quickdraww	quickdrăw
boleslaww	boleslaw	boleslaww	boleslăw
satoww	satow	satoww	satơw
condoleeezza	condoleezza	condoleeezza	condolêezza
greee	gree	greee	grêe
addditively	additively	addditively	ađditively
speeechwriter	speechwriter	speeechwriter	spêechwriter
mediterraneee	mediterranee	mediterraneee	mediterranêe
midddlebroww	middlebrow	midddlebroww	miđdlebrơw
retoook	retook	retoook	retôok
meadowwlark	meadowlark	meadowwlark	meadơwlark
geees	gees	geees	gêes
guffawws	guffaws	gufawws	guffăws
fawwzi	fawzi	fawwzi	făwzi
sambroook	sambrook	sambroook	sambrôok
preeempting	preempting	preeempting	prêempting
streeeten	streeten	streeeten	strêeten
arresteees	arrestees	aresteees	arrestêes
kurnoool	kurnool	kurnoool	kurnôol
potchefstrooom	potchefstroom	potchefstrooom	potchefstrôom
staaates	staates	staaates	stâates
crooon	croon	crooon	crôon
lagooonal	lagoonal	lagooonal	lagôonal
fishhoook	fishhook	fishhoook	fishhôok
jackdaww	jackdaw	jackdaww	jackdăw
ovenprooof	ovenproof	ovenprooof	ovenprôof
pricewaterhousecooopers	pricewaterhousecoopers	pricewaterhousecooopers	pricewaterhousecôopers
creeedal	creedal	creeedal	crêedal
crestwoood	crestwood	crestwoood	crestwôod
wooodsworth	woodsworth	uoodsworth	wôodsworth
stowwawway	stowaway	stowwawway	stơwăway
adddend	addend	adddend	ađdend
broooked	brooked	broooked	brôoked
sreee	sree	sreee	srêe
longboww	longbow	longboww	longbơw
priesthooods	priesthoods	priesthooods	priesthôods
lown	lown	lơn	lơn
lovaaas	lovaas	lovaaas	lovâas
bidddulph	biddulph	bidddulph	biđdulph
compareee	comparee	compareee	comparêe
daws	daws	dắ	dăs
shawwna	shawna	shawwna	shăwna
steeepening	steepening	steeepening	stêepening
coffeeemaker	coffeemaker	cofeeemaker	coffêemaker
zooogeography	zoogeography	zooogeography	zôogeography
killeeen	killeen	killeeen	killêen
godowwn	godown	godowwn	godơwn
farrowwing	farrowing	farrowwing	farrơwing
spoooler	spooler	spoooler	spôoler
badawwi	badawi	badawwi	badăwi
whitloww	whitlow	whitloww	whitlơw
kankakeee	kankakee	kankakeee	kankakêe
preeemployment	preemployment	preeemployment	prêemployment
shaheeen	shaheen	shaheeen	shahêen
cockatooos	cockatoos	cockatooos	cockatôos
honeymoooners	honeymooners	honeymoooners	honeymôoners
faww	faw	faww	făw
scarecrowws	scarecrows	scarecrowws	scarecrơws
inflowwing	inflowing	inflowwing	inflơwing
roop	roop	rôp	rôp
cahooots	cahoots	cahooots	cahôots
tillamoook	tillamook	tillamoook	tillamôok
adddicting	addicting	adddicting	ađdicting
droood	drood	droood	drôod
unhallowwed	unhallowed	unhallowwed	unhallơwed
bluegreeen	bluegreen	bluegreeen	bluegrêen
alaudddin	alauddin	alaudddin	alauđdin
feeeley	feeley	feeeley	fêeley
snowwcapped	snowcapped	snowwcapped	snơwcapped
sidddiqi	siddiqi	sidddiqi	siđdiqi
mussooorie	mussoorie	musooorie	mussôorie
tedddington	teddington	tedddington	teđdington
ooooooooo	oooooo	oooooooo	ôôôôo
oooooo	oooooo	ooooo	ôôô
sacagawwea	sacagawea	sacagawwea	sacagăwea
kalgooorlie	kalgoorlie	kalgooorlie	kalgôorlie
beeechwoood	beechwood	beechwoood	bêechwôod
giddding	gidding	giddding	giđding
huw	huw	hư	hư
budddhaghosa	buddhaghosa	budddhaghosa	buđdhaghosa
ballyhooo	ballyhoo	ballyhooo	ballyhôo
drooops	droops	drooops	drôops
snowwdrift	snowdrift	snowwdrift	snơwdrift
fishbowwl	fishbowl	fishbowwl	fishbơwl
hidddenness	hiddenness	hidddenness	hiđdenness
pooch	pooch	pôch	pôch
sheeeler	sheeler	sheeeler	shêeler
feeely	feely	feeely	fêely
choosers	choosers	chốe	chôsers
dhowws	dhows	dhowws	dhơws
kingswoood	kingswood	kingswoood	kingswôod
screeener	screener	screeener	scrêener
betweeene	betweene	betweeene	betwêene
wooolfs	woolfs	uoolfs	wôolfs
streeeck	streeck	streeeck	strêeck
foootballs	footballs	foootballs	fôotballs
sydoww	sydow	sydoww	sydơw
wooolfolk	woolfolk	uoolfolk	wôolfolk
lithgoww	lithgow	lithgoww	lithgơw
khadddar	khaddar	khadddar	khađdar
cesspoools	cesspools	cesspoools	cesspôols
colebroook	colebrook	colebroook	colebrôok
ludddite	luddite	ludddite	luđdite
sadddening	saddening	sadddening	sađdening
coosa	coosa	cốa	côsa
sidddhas	siddhas	sidddhas	siđdhas
boscawwen	boscawen	boscawwen	boscăwen
glendowwer	glendower	glendowwer	glendơwer
allpowwerful	allpowerful	allpowwerful	allpơwerful
browwbeat	browbeat	browwbeat	brơwbeat
cudddapah	cuddapah	cudddapah	cuđdapah
caploww	caplow	caploww	caplơw
