# English 100k Typing Variants
# Format: word TAB variant1,variant2,...
# Generated by english_telex_patterns_test.rs

been	beeen,been
see	seee,see
between	betweeen,between
how	howw,how
now	noww,now
however	howwever,however
own	owwn,own
three	threee,three
good	goood,good
down	dowwn,down
know	knoww,know
too	tooo,too
power	powwer,power
law	laww,law
need	neeed,need
school	schoool,school
following	followwing,following
book	boook,book
away	awway,away
known	knowwn,known
seen	seeen,seen
took	toook,took
free	freee,free
look	loook,look
low	loww,low
knowledge	knowwledge,knowledge
room	rooom,room
show	showw,show
shown	showwn,shown
growth	growwth,growth
toward	towward,toward
saw	saww,saw
food	foood,food
seems	seeems,seems
lower	lowwer,lower
keep	keeep,keep
looked	loooked,looked
blood	bloood,blood
feel	feeel,feel
needs	neeeds,needs
soon	sooon,soon
middle	midddle,middle
indeed	indeeed,indeed
books	boooks,books
addition	adddition,addition
seemed	seeemed,seemed
below	beloww,below
committee	committeee,committee
needed	neeeded,needed
shows	showws,shows
poor	pooor,poor
town	towwn,town
seem	seeem,seem
followed	followwed,followed
door	dooor,door
looking	loooking,looking
degree	degreee,degree
street	streeet,street
feet	feeet,feet
added	addded,added
schools	schoools,schools
flow	floww,flow
meeting	meeeting,meeting
towards	towwards,towards
follow	followw,follow
deep	deeep,deep
agreement	agreeement,agreement
laws	lawws,laws
additional	addditional,additional
freedom	freeedom,freedom
meet	meeet,meet
week	weeek,week
green	greeen,green
feeling	feeeling,feeling
follows	followws,follows
allow	alloww,allow
speech	speeech,speech
allowed	allowwed,allowed
goods	gooods,goods
brown	browwn,brown
add	addd,add
address	adddress,address
growing	growwing,growing
stood	stoood,stood
showed	showwed,showed
weeks	weeeks,weeks
floor	flooor,floor
powers	powwers,powers
tree	treee,tree
window	windoww,window
speed	speeed,speed
employees	employeees,employees
powerful	powwerful,powerful
agreed	agreeed,agreed
trees	treees,trees
understood	understoood,understood
aware	awware,aware
drawn	drawwn,drawn
wood	woood,wood
foot	fooot,foot
choose	chooose,choose
suddenly	sudddenly,suddenly
feelings	feeelings,feelings
career	careeer,career
sleep	sleeep,sleep
slowly	slowwly,slowly
knows	knowws,knows
showing	showwing,showing
steel	steeel,steel
greek	greeek,greek
seek	seeek,seek
engineering	engineeering,engineering
slow	sloww,slow
windows	windowws,windows
allows	allowws,allows
drawing	drawwing,drawing
grow	groww,grow
tools	toools,tools
draw	draww,draw
seeing	seeeing,seeing
troops	trooops,troops
looks	loooks,looks
agree	agreee,agree
keeping	keeeping,keeping
nineteenth	nineteeenth,nineteenth
queen	queeen,queen
knowing	knowwing,knowing
employee	employeee,employee
narrow	narroww,narrow
proceedings	proceeedings,proceedings
yellow	yelloww,yellow
unknown	unknowwn,unknown
owner	owwner,owner
screen	screeen,screen
fellow	felloww,fellow
root	rooot,root
grown	growwn,grown
tool	toool,tool
proof	prooof,proof
cooperation	coooperation,cooperation
meetings	meeetings,meetings
seeking	seeeking,seeking
degrees	degreees,degrees
afternoon	afternooon,afternoon
row	roww,row
sheet	sheeet,sheet
owned	owwned,owned
lee	leee,lee
flowers	flowwers,flowers
rooms	roooms,rooms
awareness	awwareness,awareness
coffee	coffeee,coffee
childhood	childhoood,childhood
moon	mooon,moon
deeply	deeeply,deeply
streets	streeets,streets
towns	towwns,towns
teeth	teeeth,teeth
roots	rooots,roots
snow	snoww,snow
sweet	sweeet,sweet
fifteen	fifteeen,fifteen
sees	seees,sees
addressed	adddressed,addressed
raw	raww,raw
ownership	owwnership,ownership
sudden	suddden,sudden
adding	addding,adding
hidden	hiddden,hidden
crown	crowwn,crown
owners	owwners,owners
allowing	allowwing,allowing
smooth	smoooth,smooth
feed	feeed,feed
crowd	crowwd,crowd
moscow	moscoww,moscow
classroom	classrooom,classroom
cool	coool,cool
somehow	somehoww,somehow
cook	coook,cook
seed	seeed,seed
succeeded	succeeeded,succeeded
feels	feeels,feels
eighteenth	eighteeenth,eighteenth
pool	poool,pool
agreements	agreeements,agreements
doors	dooors,doors
shook	shoook,shook
lawyer	lawwyer,lawyer
flows	flowws,flows
roof	rooof,roof
proceed	proceeed,proceed
feeding	feeeding,feeding
foods	fooods,foods
tomorrow	tomorroww,tomorrow
lawrence	lawwrence,lawrence
mood	moood,mood
shadow	shadoww,shadow
loose	looose,loose
loop	looop,loop
feedback	feeedback,feedback
throw	throww,throw
lowest	lowwest,lowest
wooden	woooden,wooden
nodded	noddded,nodded
weekly	weeekly,weekly
fee	feee,fee
deeper	deeeper,deeper
woods	wooods,woods
roosevelt	rooosevelt,roosevelt
fees	feees,fees
tower	towwer,tower
engineers	engineeers,engineers
wheel	wheeel,wheel
award	awward,award
sheep	sheeep,sheep
creek	creeek,creek
blow	bloww,blow
flower	flowwer,flower
neighborhood	neighborhoood,neighborhood
cooperative	coooperative,cooperative
seeds	seeeds,seeds
thrown	throwwn,thrown
howard	howward,howard
committees	committeees,committees
odd	oddd,odd
freely	freeely,freely
guarantee	guaranteee,guarantee
fleet	fleeet,fleet
thee	theee,thee
moore	mooore,moore
engineer	engineeer,engineer
lawyers	lawwyers,lawyers
wedding	weddding,wedding
greece	greeece,greece
beer	beeer,beer
succeed	succeeed,succeed
sleeping	sleeeping,sleeping
adds	addds,adds
addresses	adddresses,addresses
proceeds	proceeeds,proceeds
choosing	chooosing,choosing
acknowledged	acknowwledged,acknowledged
sheets	sheeets,sheets
withdrawal	withdrawwal,withdrawal
deemed	deeemed,deemed
keeps	keeeps,keeps
powder	powwder,powder
owing	owwing,owing
flood	floood,flood
handbook	handboook,handbook
cooking	coooking,cooking
exceed	exceeed,exceed
seeks	seeeks,seeks
followers	followwers,followers
seventeenth	seventeeenth,seventeenth
bowl	bowwl,bowl
dawn	dawwn,dawn
coordination	cooordination,coordination
knees	kneees,knees
eighteen	eighteeen,eighteen
acknowledge	acknowwledge,acknowledge
drawings	drawwings,drawings
fourteen	fourteeen,fourteen
bedroom	bedrooom,bedroom
grows	growws,grows
bow	boww,bow
knee	kneee,knee
rows	rowws,rows
sixteen	sixteeen,sixteen
likelihood	likelihoood,likelihood
proceeded	proceeeded,proceeded
bleeding	bleeeding,bleeding
shallow	shalloww,shallow
cooling	coooling,cooling
outlook	outloook,outlook
breeding	breeeding,breeding
arrow	arroww,arrow
shoot	shooot,shoot
cheese	cheeese,cheese
proceeding	proceeeding,proceeding
shooting	shoooting,shooting
screening	screeening,screening
peer	peeer,peer
seemingly	seeemingly,seemingly
asleep	asleeep,asleep
football	foootball,football
thirteen	thirteeen,thirteen
poorly	pooorly,poorly
nowhere	nowwhere,nowhere
needle	neeedle,needle
breakdown	breakdowwn,breakdown
speeches	speeeches,speeches
esteem	esteeem,esteem
sooner	soooner,sooner
fool	foool,fool
flowing	flowwing,flowing
sixteenth	sixteeenth,sixteenth
cooper	coooper,cooper
shadows	shadowws,shadows
refugees	refugeees,refugees
tennessee	tennesseee,tennessee
coordinate	cooordinate,coordinate
embedded	embeddded,embedded
buddhist	budddhist,buddhist
meets	meeets,meets
decree	decreee,decree
volunteers	volunteeers,volunteers
draws	drawws,draws
lowered	lowwered,lowered
crowded	crowwded,crowded
deer	deeer,deer
widow	widoww,widow
addressing	adddressing,addressing
buddha	budddha,buddha
awarded	awwarded,awarded
guaranteed	guaranteeed,guaranteed
iowa	iowwa,iowa
wool	woool,wool
cow	coww,cow
downward	dowwnward,downward
bloody	blooody,bloody
hollywood	hollywoood,hollywood
peers	peeers,peers
goodness	gooodness,goodness
deeds	deeeds,deeds
tooth	toooth,tooth
greeks	greeeks,greeks
allowance	allowwance,allowance
rooted	roooted,rooted
forbidden	forbiddden,forbidden
borrowed	borrowwed,borrowed
shaw	shaww,shaw
steep	steeep,steep
throwing	throwwing,throwing
hollow	holloww,hollow
deed	deeed,deed
keen	keeen,keen
beef	beeef,beef
goddess	godddess,goddess
bladder	bladdder,bladder
withdraw	withdraww,withdraw
sheer	sheeer,sheer
reed	reeed,reed
sorrow	sorroww,sorrow
wheels	wheeels,wheels
noon	nooon,noon
boots	booots,boots
volunteer	volunteeer,volunteer
weekend	weeekend,weekend
cheek	cheeek,cheek
odds	oddds,odds
trustee	trusteee,trustee
awards	awwards,awards
seventeen	seventeeen,seventeen
isaac	isaaac,isaac
schooling	schoooling,schooling
buddhism	budddhism,buddhism
coordinates	cooordinates,coordinates
exceeds	exceeeds,exceeds
boom	booom,boom
withdrawn	withdrawwn,withdrawn
careers	careeers,careers
awful	awwful,awful
pioneer	pioneeer,pioneer
trustees	trusteees,trustees
cooked	coooked,cooked
mcgraw	mcgraww,mcgraw
arrows	arrowws,arrows
ieee	ieeee,ieee
hook	hoook,hook
bathroom	bathrooom,bathroom
fourteenth	fourteeenth,fourteenth
awake	awwake,awake
foolish	fooolish,foolish
owe	owwe,owe
freed	freeed,freed
owed	owwed,owed
hawaii	hawwaii,hawaii
aa	aaa,aa
straw	straww,straw
cheeks	cheeeks,cheeks
daddy	dadddy,daddy
exceeded	exceeeded,exceeded
borrowing	borrowwing,borrowing
agrees	agreees,agrees
outdoor	outdooor,outdoor
cows	cowws,cows
additionally	addditionally,additionally
eisenhower	eisenhowwer,eisenhower
bloom	blooom,bloom
downtown	dowwntowwn,downtown
ladder	laddder,ladder
fellows	fellowws,fellows
fellowship	fellowwship,fellowship
powell	powwell,powell
slower	slowwer,slower
manpower	manpowwer,manpower
hood	hoood,hood
fifteenth	fifteeenth,fifteenth
overlooked	overloooked,overlooked
shower	showwer,shower
exceeding	exceeeding,exceeding
owen	owwen,owen
doorway	dooorway,doorway
breed	breeed,breed
floors	flooors,floors
jaw	jaww,jaw
guarantees	guaranteees,guarantees
blown	blowwn,blown
textbook	textboook,textbook
saddle	sadddle,saddle
marrow	marroww,marrow
brooks	broooks,brooks
freezing	freeezing,freezing
elbow	elboww,elbow
unaware	unawware,unaware
nineteen	nineteeen,nineteen
freeman	freeeman,freeman
lowering	lowwering,lowering
speeds	speeeds,speeds
borrow	borroww,borrow
sweep	sweeep,sweep
greeted	greeeted,greeted
disagreement	disagreeement,disagreement
additions	addditions,additions
towers	towwers,towers
disagree	disagreee,disagree
sweeping	sweeeping,sweeping
booth	boooth,booth
blowing	blowwing,blowing
bowel	bowwel,bowel
coordinated	cooordinated,coordinated
thirteenth	thirteeenth,thirteenth
awkward	awwkward,awkward
glow	gloww,glow
crowds	crowwds,crowds
succeeding	succeeeding,succeeding
breeze	breeeze,breeze
lawn	lawwn,lawn
delaware	delawware,delaware
cooperate	coooperate,cooperate
chooses	choooses,chooses
warsaw	warsaww,warsaw
teaspoon	teaspooon,teaspoon
glasgow	glasgoww,glasgow
freeze	freeeze,freeze
morrow	morroww,morrow
textbooks	textboooks,textbooks
exceedingly	exceeedingly,exceedingly
ottawa	ottawwa,ottawa
heels	heeels,heels
bee	beee,bee
steering	steeering,steering
endowed	endowwed,endowed
nowadays	nowwadays,nowadays
poorer	pooorer,poorer
brooklyn	broooklyn,brooklyn
boot	booot,boot
swallowed	swallowwed,swallowed
allowances	allowwances,allowances
hoover	hooover,hoover
liverpool	liverpoool,liverpool
neighbourhood	neighbourhoood,neighbourhood
pools	poools,pools
refugee	refugeee,refugee
deepest	deeepest,deepest
greene	greeene,greene
neighborhoods	neighborhooods,neighborhoods
aaron	aaaron,aaron
loops	looops,loops
balloon	ballooon,balloon
flowering	flowwering,flowering
loosely	looosely,loosely
vowel	vowwel,vowel
blows	blowws,blows
creed	creeed,creed
cooled	coooled,cooled
downstream	dowwnstream,downstream
smoothly	smooothly,smoothly
addiction	adddiction,addiction
cheerful	cheeerful,cheerful
owns	owwns,owns
footnote	foootnote,footnote
classrooms	classroooms,classrooms
awakening	awwakening,awakening
bowed	bowwed,bowed
microwave	microwwave,microwave
crow	croww,crow
swallow	swalloww,swallow
township	towwnship,township
weed	weeed,weed
undertook	undertoook,undertook
bees	beees,bees
tablespoons	tablespooons,tablespoons
throws	throwws,throws
browser	browwser,browser
creep	creeep,creep
weeds	weeeds,weeds
lawful	lawwful,lawful
screens	screeens,screens
brotherhood	brotherhoood,brotherhood
pillow	pilloww,pillow
notebook	noteboook,notebook
seeming	seeeming,seeming
awe	awwe,awe
reef	reeef,reef
brow	broww,brow
downstairs	dowwnstairs,downstairs
adulthood	adulthoood,adulthood
pioneers	pioneeers,pioneers
powered	powwered,powered
acknowledgments	acknowwledgments,acknowledgments
slowed	slowwed,slowed
awaiting	awwaiting,awaiting
awakened	awwakened,awakened
agreeable	agreeeable,agreeable
gown	gowwn,gown
proofs	prooofs,proofs
doomed	dooomed,doomed
howe	howwe,howe
heel	heeel,heel
englewood	englewoood,englewood
eddie	edddie,eddie
flowed	flowwed,flowed
overthrow	overthroww,overthrow
drawer	drawwer,drawer
teenagers	teeenagers,teenagers
unlawful	unlawwful,unlawful
rainbow	rainboww,rainbow
brook	broook,brook
todd	toddd,todd
crawford	crawwford,crawford
goodwill	gooodwill,goodwill
stool	stoool,stool
worksheet	worksheeet,worksheet
hawk	hawwk,hawk
greeting	greeeting,greeting
footsteps	foootsteps,footsteps
landowners	landowwners,landowners
squeezed	squeeezed,squeezed
peel	peeel,peel
spoon	spooon,spoon
microorganisms	microoorganisms,microorganisms
frowned	frowwned,frowned
needless	neeedless,needless
beethoven	beeethoven,beethoven
bamboo	bambooo,bamboo
coordinating	cooordinating,coordinating
needles	neeedles,needles
glowing	glowwing,glowing
wheeler	wheeeler,wheeler
meadow	meadoww,meadow
goodman	gooodman,goodman
milwaukee	milwaukeee,milwaukee
cooperatives	coooperatives,cooperatives
weeping	weeeping,weeping
troop	trooop,troop
addison	adddison,addison
drowned	drowwned,drowned
spleen	spleeen,spleen
greenhouse	greeenhouse,greenhouse
narrowly	narrowwly,narrowly
greed	greeed,greed
squeeze	squeeeze,squeeze
queer	queeer,queer
acknowledgment	acknowwledgment,acknowledgment
feeble	feeeble,feeble
towel	towwel,towel
empowered	empowwered,empowered
boost	booost,boost
teenage	teeenage,teenage
needing	neeeding,needing
feeds	feeeds,feeds
oo	ooo,oo
sleeve	sleeeve,sleeve
owes	owwes,owes
teen	teeen,teen
endowment	endowwment,endowment
teens	teeens,teens
subcommittee	subcommitteee,subcommittee
flee	fleee,flee
roofs	rooofs,roofs
floods	flooods,floods
acknowledges	acknowwledges,acknowledges
keeper	keeeper,keeper
lowell	lowwell,lowell
bidding	biddding,bidding
knowledgeable	knowwledgeable,knowledgeable
yearbook	yearboook,yearbook
renowned	renowwned,renowned
browning	browwning,browning
goodbye	gooodbye,goodbye
preschool	preschoool,preschool
footing	foooting,footing
eyebrows	eyebrowws,eyebrows
acknowledging	acknowwledging,acknowledging
coordinator	cooordinator,coordinator
crowned	crowwned,crowned
shoots	shooots,shoots
eec	eeec,eec
flooded	floooded,flooded
additive	addditive,additive
flooding	floooding,flooding
overlooking	overloooking,overlooking
await	awwait,await
kuwait	kuwwait,kuwait
narrowed	narrowwed,narrowed
empowerment	empowwerment,empowerment
livelihood	livelihoood,livelihood
goose	gooose,goose
weekends	weeekends,weekends
unseen	unseeen,unseen
meadows	meadowws,meadows
narrower	narrowwer,narrower
allowable	allowwable,allowable
powerless	powwerless,powerless
freedoms	freeedoms,freedoms
hawthorne	hawwthorne,hawthorne
woodland	wooodland,woodland
overlook	overloook,overlook
agreeing	agreeeing,agreeing
greet	greeet,greet
gloomy	glooomy,gloomy
moonlight	mooonlight,moonlight
awaited	awwaited,awaited
owl	owwl,owl
yankee	yankeee,yankee
groove	grooove,groove
indoor	indooor,indoor
acknowledgements	acknowwledgements,acknowledgements
cookies	coookies,cookies
widows	widowws,widows
buddy	budddy,buddy
vowels	vowwels,vowels
pioneering	pioneeering,pioneering
flown	flowwn,flown
jaws	jawws,jaws
bestowed	bestowwed,bestowed
decrees	decreees,decrees
owning	owwning,owning
boolean	booolean,boolean
eddy	edddy,eddy
cheer	cheeer,cheer
bowls	bowwls,bowls
muddy	mudddy,muddy
manhood	manhoood,manhood
zoo	zooo,zoo
queens	queeens,queens
moods	mooods,moods
toolbar	tooolbar,toolbar
dawson	dawwson,dawson
downs	dowwns,downs
willow	willoww,willow
growers	growwers,growers
cooler	coooler,cooler
kathleen	kathleeen,kathleen
greenwood	greeenwoood,greenwood
hawaiian	hawwaiian,hawaiian
borrower	borrowwer,borrower
gloom	glooom,gloom
poorest	pooorest,poorest
breeds	breeeds,breeds
queensland	queeensland,queensland
greens	greeens,greens
priesthood	priesthoood,priesthood
hawkins	hawwkins,hawkins
motherhood	motherhoood,motherhood
paddy	padddy,paddy
cowboy	cowwboy,cowboy
seedlings	seeedlings,seedlings
groom	grooom,groom
fools	foools,fools
reel	reeel,reel
ridden	riddden,ridden
succeeds	succeeeds,succeeds
reddish	redddish,reddish
courtroom	courtrooom,courtroom
heed	heeed,heed
misunderstood	misunderstoood,misunderstood
mushrooms	mushroooms,mushrooms
bloomington	blooomington,bloomington
tablespoon	tablespooon,tablespoon
fowler	fowwler,fowler
moody	mooody,moody
hooks	hoooks,hooks
narrowing	narrowwing,narrowing
doom	dooom,doom
ee	eee,ee
sleeves	sleeeves,sleeves
woody	wooody,woody
cartoon	cartooon,cartoon
slowing	slowwing,slowing
steer	steeer,steer
volunteered	volunteeered,volunteered
oddly	odddly,oddly
dow	doww,dow
peered	peeered,peered
vow	voww,vow
awoke	awwoke,awoke
eeg	eeeg,eeg
brooke	broooke,brooke
needy	neeedy,needy
outdoors	outdooors,outdoors
hooked	hoooked,hooked
booklet	boooklet,booklet
browne	browwne,browne
disagreed	disagreeed,disagreed
anyhow	anyhoww,anyhow
outflow	outfloww,outflow
sweetness	sweeetness,sweetness
bows	bowws,bows
crawl	crawwl,crawl
weep	weeep,weep
teenager	teeenager,teenager
lawsuit	lawwsuit,lawsuit
steele	steeele,steele
cherokee	cherokeee,cherokee
flaws	flawws,flaws
screened	screeened,screened
steels	steeels,steels
leeds	leeeds,leeds
powerfully	powwerfully,powerfully
sown	sowwn,sown
greenland	greeenland,greenland
greenwich	greeenwich,greenwich
swallowing	swallowwing,swallowing
disagreements	disagreeements,disagreements
follower	followwer,follower
creeping	creeeping,creeping
dee	deee,dee
awhile	awwhile,awhile
vows	vowws,vows
woolf	wooolf,woolf
teddy	tedddy,teddy
taboo	tabooo,taboo
hooker	hoooker,hooker
speedy	speeedy,speedy
elbows	elbowws,elbows
crawled	crawwled,crawled
footnotes	foootnotes,footnotes
fleeing	fleeeing,fleeing
withdrawing	withdrawwing,withdrawing
acknowledgement	acknowwledgement,acknowledgement
overflow	overfloww,overflow
yiddish	yidddish,yiddish
bedding	beddding,bedding
inflow	infloww,inflow
crooked	croooked,crooked
rupees	rupeees,rupees
woodward	wooodward,woodward
greedy	greeedy,greedy
deepening	deeepening,deepening
cooke	coooke,cooke
coward	cowward,coward
seekers	seeekers,seekers
drowning	drowwning,drowning
sleepy	sleeepy,sleepy
spreadsheet	spreadsheeet,spreadsheet
lawson	lawwson,lawson
kneeling	kneeeling,kneeling
powdered	powwdered,powdered
greenberg	greeenberg,greenberg
wheelchair	wheeelchair,wheelchair
download	dowwnload,download
saddam	sadddam,saddam
showers	showwers,showers
cheerfully	cheeerfully,cheerfully
saloon	salooon,saloon
crawling	crawwling,crawling
downwards	dowwnwards,downwards
foodstuffs	fooodstuffs,foodstuffs
sow	soww,sow
fleeting	fleeeting,fleeting
drawers	drawwers,drawers
cookie	coookie,cookie
bowen	bowwen,bowen
crowns	crowwns,crowns
lessee	lesseee,lessee
bowling	bowwling,bowling
wee	weee,wee
trainees	traineees,trainees
bedrooms	bedroooms,bedrooms
loom	looom,loom
ooo	oooo,ooo
awaken	awwaken,awaken
engineered	engineeered,engineered
redeemed	redeeemed,redeemed
awesome	awwesome,awesome
platoon	platooon,platoon
smoothing	smooothing,smoothing
foreseen	foreseeen,foreseen
forbidding	forbiddding,forbidding
soothing	sooothing,soothing
aberdeen	aberdeeen,aberdeen
wooded	woooded,wooded
nodding	noddding,nodding
wheeled	wheeeled,wheeled
smoothed	smooothed,smoothed
claws	clawws,claws
crowding	crowwding,crowding
peeled	peeeled,peeled
jeep	jeeep,jeep
additives	addditives,additives
flaw	flaww,flaw
townsend	towwnsend,townsend
riddle	ridddle,riddle
decreed	decreeed,decreed
tow	toww,tow
dd	ddd,dd
deepened	deeepened,deepened
reefs	reeefs,reefs
freeing	freeeing,freeing
aw	aww,aw
lagoon	lagooon,lagoon
keenly	keeenly,keenly
greetings	greeetings,greetings
geese	geeese,geese
howell	howwell,howell
esteemed	esteeemed,esteemed
yellowish	yellowwish,yellowish
tee	teee,tee
beetle	beeetle,beetle
drawbacks	drawwbacks,drawbacks
yankees	yankeees,yankees
flawed	flawwed,flawed
towering	towwering,towering
towels	towwels,towels
shadowy	shadowwy,shadowy
downfall	dowwnfall,downfall
borrowers	borrowwers,borrowers
georgetown	georgetowwn,georgetown
plywood	plywoood,plywood
kierkegaard	kierkegaaard,kierkegaard
indoors	indooors,indoors
cooks	coooks,cooks
seafood	seafoood,seafood
lowland	lowwland,lowland
moor	mooor,moor
deem	deeem,deem
woodrow	wooodroww,woodrow
lowe	lowwe,lowe
sowing	sowwing,sowing
newsweek	newsweeek,newsweek
housekeeping	housekeeeping,housekeeping
middleton	midddleton,middleton
aloof	alooof,aloof
drawback	drawwback,drawback
foreseeable	foreseeeable,foreseeable
frown	frowwn,frown
sorrows	sorrowws,sorrows
fodder	foddder,fodder
pooled	poooled,pooled
disagreeable	disagreeeable,disagreeable
landowner	landowwner,landowner
workbook	workboook,workbook
mushroom	mushrooom,mushroom
widowed	widowwed,widowed
evergreen	evergreeen,evergreen
beetles	beeetles,beetles
knowingly	knowwingly,knowingly
falsehood	falsehoood,falsehood
lowers	lowwers,lowers
wow	woww,wow
runaway	runawway,runaway
coworkers	cowworkers,coworkers
cartoons	cartooons,cartoons
addicts	adddicts,addicts
discreet	discreeet,discreet
notebooks	noteboooks,notebooks
foresee	foreseee,foresee
feeder	feeeder,feeder
rowe	rowwe,rowe
barrow	barroww,barrow
brood	broood,brood
transvaal	transvaaal,transvaal
naacp	naaacp,naacp
sweetheart	sweeetheart,sweetheart
devotees	devoteees,devotees
sparrow	sparroww,sparrow
midday	middday,midday
clown	clowwn,clown
redeem	redeeem,redeem
parenthood	parenthoood,parenthood
pillows	pillowws,pillows
peering	peeering,peering
licensee	licenseee,licensee
shedding	sheddding,shedding
cheered	cheeered,cheered
goodwin	gooodwin,goodwin
speeding	speeeding,speeding
gaas	gaaas,gaas
housekeeper	housekeeeper,housekeeper
pudding	puddding,pudding
monsoon	monsooon,monsoon
browse	browwse,browse
boon	booon,boon
paddle	padddle,paddle
moose	mooose,moose
broom	brooom,broom
plow	ploww,plow
dowry	dowwry,dowry
jubilee	jubileee,jubilee
grassroots	grassrooots,grassroots
zoom	zooom,zoom
kluwer	kluwwer,kluwer
huddled	hudddled,huddled
cooperating	coooperating,cooperating
lookout	loookout,lookout
strawberry	strawwberry,strawberry
vowed	vowwed,vowed
owens	owwens,owens
buddhists	budddhists,buddhists
powders	powwders,powders
bowman	bowwman,bowman
boyhood	boyhoood,boyhood
prowess	prowwess,prowess
addicted	adddicted,addicted
freer	freeer,freer
lowlands	lowwlands,lowlands
een	eeen,een
fowl	fowwl,fowl
crook	croook,crook
cheers	cheeers,cheers
speedily	speeedily,speedily
galilee	galileee,galilee
grooves	groooves,grooves
seawater	seawwater,seawater
dodd	doddd,dodd
bookstore	boookstore,bookstore
waterloo	waterlooo,waterloo
bleed	bleeed,bleed
keepers	keeepers,keepers
lawsuits	lawwsuits,lawsuits
sawyer	sawwyer,sawyer
honeymoon	honeymooon,honeymoon
womanhood	womanhoood,womanhood
cheering	cheeering,cheering
drown	drowwn,drown
nee	neee,nee
stools	stoools,stools
afternoons	afternooons,afternoons
brows	browws,brows
barlow	barloww,barlow
aaa	aaaa,aaa
rawls	rawwls,rawls
pharisees	phariseees,pharisees
pooling	poooling,pooling
firewood	firewoood,firewood
boone	booone,boone
goddesses	godddesses,goddesses
freedman	freeedman,freedman
looms	loooms,looms
brookings	broookings,brookings
growled	growwled,growled
moors	mooors,moors
bridegroom	bridegrooom,bridegroom
kidding	kiddding,kidding
downhill	dowwnhill,downhill
sweets	sweeets,sweets
loosen	looosen,loosen
seeker	seeeker,seeker
beech	beeech,beech
bloodshed	blooodshed,bloodshed
hawks	hawwks,hawks
sleeps	sleeeps,sleeps
pioneered	pioneeered,pioneered
brooding	broooding,brooding
bestow	bestoww,bestow
footage	foootage,footage
threefold	threeefold,threefold
weddings	wedddings,weddings
outlaw	outlaww,outlaw
horsepower	horsepowwer,horsepower
gee	geee,gee
preexisting	preeexisting,preexisting
bowing	bowwing,bowing
beet	beeet,beet
unforeseen	unforeseeen,unforeseen
zoology	zooology,zoology
snowy	snowwy,snowy
reeds	reeeds,reeds
loosened	looosened,loosened
malawi	malawwi,malawi
spawning	spawwning,spawning
howling	howwling,howling
zool	zoool,zool
squeezing	squeeezing,squeezing
cowboys	cowwboys,cowboys
granddaughter	grandddaughter,granddaughter
endowments	endowwments,endowments
eileen	eileeen,eileen
marlowe	marlowwe,marlowe
balloons	ballooons,balloons
sherwood	sherwoood,sherwood
downing	dowwning,downing
ddt	dddt,ddt
budding	buddding,budding
lowly	lowwly,lowly
shuddered	shudddered,shuddered
burrows	burrowws,burrows
poole	pooole,poole
meek	meeek,meek
blooms	bloooms,blooms
fleets	fleeets,fleets
hardwood	hardwoood,hardwood
oversee	overseee,oversee
booming	boooming,booming
teaspoons	teaspooons,teaspoons
awaits	awwaits,awaits
paw	paww,paw
greenish	greeenish,greenish
troubleshooting	troubleshoooting,troubleshooting
nominee	nomineee,nominee
loomed	looomed,loomed
claw	claww,claw
awfully	awwfully,awfully
guaranteeing	guaranteeeing,guaranteeing
sweeps	sweeeps,sweeps
overthrown	overthrowwn,overthrown
schooner	schoooner,schooner
empowering	empowwering,empowering
blooded	bloooded,blooded
cameroon	camerooon,cameroon
addict	adddict,addict
strawberries	strawwberries,strawberries
embedding	embeddding,embedding
booked	boooked,booked
creeks	creeeks,creeks
beecher	beeecher,beecher
avowed	avowwed,avowed
maureen	maureeen,maureen
overshadowed	overshadowwed,overshadowed
reeves	reeeves,reeves
shudder	shuddder,shudder
townships	towwnships,townships
padded	paddded,padded
gallbladder	gallbladdder,gallbladder
coolidge	cooolidge,coolidge
rowland	rowwland,rowland
overflowing	overflowwing,overflowing
lawns	lawwns,lawns
steered	steeered,steered
dawned	dawwned,dawned
beers	beeers,beers
downright	dowwnright,downright
deepen	deeepen,deepen
barefoot	barefooot,barefoot
bidder	biddder,bidder
eyebrow	eyebroww,eyebrow
hometown	hometowwn,hometown
shawl	shawwl,shawl
trainee	traineee,trainee
toddler	todddler,toddler
middlesex	midddlesex,middlesex
rees	reees,rees
yellowstone	yellowwstone,yellowstone
foothills	fooothills,foothills
scoop	scooop,scoop
freezer	freeezer,freezer
gunpowder	gunpowwder,gunpowder
veneer	veneeer,veneer
slows	slowws,slows
blooming	bloooming,blooming
peacekeeping	peacekeeeping,peacekeeping
breeders	breeeders,breeders
bowers	bowwers,bowers
bower	bowwer,bower
fallow	falloww,fallow
empower	empowwer,empower
taboos	tabooos,taboos
crows	crowws,crows
pedigree	pedigreee,pedigree
steeply	steeeply,steeply
keel	keeel,keel
cowardice	cowwardice,cowardice
canaan	canaaan,canaan
bloodstream	blooodstream,bloodstream
sprawling	sprawwling,sprawling
statehood	statehoood,statehood
bowels	bowwels,bowels
frowning	frowwning,frowning
voor	vooor,voor
outgrowth	outgrowwth,outgrowth
fellowships	fellowwships,fellowships
haas	haaas,haas
browsing	browwsing,browsing
grooming	groooming,grooming
glowed	glowwed,glowed
thaw	thaww,thaw
goddard	godddard,goddard
breastfeeding	breastfeeeding,breastfeeding
cowardly	cowwardly,cowardly
inflows	inflowws,inflows
reindeer	reindeeer,reindeer
spawned	spawwned,spawned
seer	seeer,seer
eerie	eeerie,eerie
bellows	bellowws,bellows
footwear	foootwear,footwear
schoolmaster	schooolmaster,schoolmaster
fiddle	fidddle,fiddle
howells	howwells,howells
goddamn	godddamn,goddamn
musee	museee,musee
screenplay	screeenplay,screenplay
mcdowell	mcdowwell,mcdowell
rudder	ruddder,rudder
lawfully	lawwfully,lawfully
ballroom	ballrooom,ballroom
footprints	foootprints,footprints
devotee	devoteee,devotee
freedmen	freeedmen,freedmen
referee	refereee,referee
woo	wooo,woo
overcrowded	overcrowwded,overcrowded
bazaar	bazaaar,bazaar
fooled	foooled,fooled
brownish	browwnish,brownish
woodlands	wooodlands,woodlands
horowitz	horowwitz,horowitz
chow	choww,chow
sunflower	sunflowwer,sunflower
interviewees	intervieweees,interviewees
harlow	harloww,harlow
browsers	browwsers,browsers
woollen	wooollen,woollen
flowered	flowwered,flowered
freeway	freeeway,freeway
hoop	hooop,hoop
awkwardly	awwkwardly,awkwardly
gowns	gowwns,gowns
loosening	looosening,loosening
steeped	steeeped,steeped
reese	reeese,reese
sweetly	sweeetly,sweetly
freddie	fredddie,freddie
breeder	breeeder,breeder
jawaharlal	jawwaharlal,jawaharlal
deems	deeems,deems
reelection	reeelection,reelection
powerpoint	powwerpoint,powerpoint
sleek	sleeek,sleek
booking	boooking,booking
powerlessness	powwerlessness,powerlessness
stowe	stowwe,stowe
borrowings	borrowwings,borrowings
soot	sooot,soot
peeling	peeeling,peeling
looming	loooming,looming
seedling	seeedling,seedling
eel	eeel,eel
howl	howwl,howl
freelance	freeelance,freelance
lawless	lawwless,lawless
footed	foooted,footed
booty	boooty,booty
rowan	rowwan,rowan
workflow	workfloww,workflow
creeds	creeeds,creeds
peep	peeep,peep
lucknow	lucknoww,lucknow
troopers	trooopers,troopers
redeemer	redeeemer,redeemer
booster	boooster,booster
greeley	greeeley,greeley
overgrown	overgrowwn,overgrown
withdrawals	withdrawwals,withdrawals
moons	mooons,moons
maslow	masloww,maslow
coolness	cooolness,coolness
toddlers	todddlers,toddlers
foothold	fooothold,foothold
seeded	seeeded,seeded
bowles	bowwles,bowles
doorstep	dooorstep,doorstep
paws	pawws,paws
wheeling	wheeeling,wheeling
roofing	rooofing,roofing
rowing	rowwing,rowing
kneel	kneeel,kneel
overseer	overseeer,overseer
hooper	hoooper,hooper
studded	studdded,studded
foresaw	foresaww,foresaw
crowning	crowwning,crowning
ladders	laddders,ladders
townspeople	towwnspeople,townspeople
outlawed	outlawwed,outlawed
renown	renowwn,renown
stooped	stoooped,stooped
genteel	genteeel,genteel
breeches	breeeches,breeches
bookkeeping	boookkeeeping,bookkeeping
peek	peeek,peek
burrow	burroww,burrow
chimpanzees	chimpanzeees,chimpanzees
tweed	tweeed,tweed
addictive	adddictive,addictive
seeding	seeeding,seeding
owls	owwls,owls
redwood	redwoood,redwood
absenteeism	absenteeeism,absenteeism
underwood	underwoood,underwood
shredded	shreddded,shredded
bathrooms	bathroooms,bathrooms
coolly	cooolly,coolly
soothe	sooothe,soothe
greenfield	greeenfield,greenfield
zoological	zooological,zoological
wellknown	wellknowwn,wellknown
swallows	swallowws,swallows
bibliobazaar	bibliobazaaar,bibliobazaar
bungalow	bungaloww,bungalow
judd	juddd,judd
overpowering	overpowwering,overpowering
reddy	redddy,reddy
foolishness	fooolishness,foolishness
shopkeepers	shopkeeepers,shopkeepers
adduced	addduced,adduced
cowan	cowwan,cowan
cooperated	coooperated,cooperated
booker	boooker,booker
google	gooogle,google
spoons	spooons,spoons
hee	heee,hee
booths	boooths,booths
stoop	stooop,stoop
winslow	winsloww,winslow
noodles	nooodles,noodles
shadowed	shadowwed,shadowed
feeders	feeeders,feeders
wedded	weddded,wedded
woolen	wooolen,woolen
awarding	awwarding,awarding
speechless	speeechless,speechless
handbooks	handboooks,handbooks
homeowners	homeowwners,homeowners
unknowns	unknowwns,unknowns
coolant	cooolant,coolant
narrows	narrowws,narrows
overcrowding	overcrowwding,overcrowding
lowry	lowwry,lowry
steeper	steeeper,steeper
gower	gowwer,gower
knowles	knowwles,knowles
okinawa	okinawwa,okinawa
roommate	rooommate,roommate
rooting	roooting,rooting
seaweed	seawweeed,seaweed
greer	greeer,greer
foote	fooote,foote
gallows	gallowws,gallows
looting	loooting,looting
superpower	superpowwer,superpower
trusteeship	trusteeeship,trusteeship
glee	gleee,glee
showered	showwered,showered
flooring	floooring,flooring
buddies	budddies,buddies
discreetly	discreeetly,discreetly
willows	willowws,willows
salaam	salaaam,salaam
absentee	absenteee,absentee
overlooks	overloooks,overlooks
sheen	sheeen,sheen
superpowers	superpowwers,superpowers
addis	adddis,addis
addressee	adddresseee,addressee
mcgee	mcgeee,mcgee
pow	poww,pow
loo	looo,loo
redeeming	redeeeming,redeeming
faa	faaa,faa
longfellow	longfelloww,longfellow
smoother	smooother,smoother
cowley	cowwley,cowley
loot	looot,loot
drooping	droooping,drooping
tokugawa	tokugawwa,tokugawa
schoolboy	schooolboy,schoolboy
poona	pooona,poona
padding	paddding,padding
browns	browwns,browns
slowness	slowwness,slowness
furrow	furroww,furrow
mellow	melloww,mellow
drowsiness	drowwsiness,drowsiness
canteen	canteeen,canteen
holloway	hollowway,holloway
grower	growwer,grower
cooley	coooley,cooley
sorrowful	sorrowwful,sorrowful
chinatown	chinatowwn,chinatown
sarawak	sarawwak,sarawak
scooped	scoooped,scooped
bowie	bowwie,bowie
nominees	nomineees,nominees
boo	booo,boo
doorways	dooorways,doorways
moot	mooot,moot
interviewee	intervieweee,interviewee
galloway	gallowway,galloway
crowley	crowwley,crowley
transferee	transfereee,transferee
pawn	pawwn,pawn
frees	freees,frees
sweeney	sweeeney,sweeney
baal	baaal,baal
breakdowns	breakdowwns,breakdowns
haworth	hawworth,haworth
plowing	plowwing,plowing
downloaded	dowwnloaded,downloaded
roofed	rooofed,roofed
kangaroo	kangarooo,kangaroo
tattoo	tattooo,tattoo
worksheets	worksheeets,worksheets
riddles	ridddles,riddles
smoothness	smooothness,smoothness
bylaws	bylawws,bylaws
outlaws	outlawws,outlaws
mohawk	mohawwk,mohawk
fawcett	fawwcett,fawcett
ow	oww,ow
uprooted	uproooted,uprooted
sprawled	sprawwled,sprawled
bookseller	boookseller,bookseller
weeding	weeeding,weeding
mooney	moooney,mooney
biofeedback	biofeeedback,biofeedback
hooves	hoooves,hooves
giddens	gidddens,giddens
carefree	carefreee,carefree
lockwood	lockwoood,lockwood
renee	reneee,renee
halloween	hallowweeen,halloween
borrows	borrowws,borrows
buddhas	budddhas,buddhas
shutdown	shutdowwn,shutdown
bradshaw	bradshaww,bradshaw
chimpanzee	chimpanzeee,chimpanzee
towed	towwed,towed
airflow	airfloww,airflow
mortgagee	mortgageee,mortgagee
hoof	hooof,hoof
lockheed	lockheeed,lockheed
reestablish	reeestablish,reestablish
schoolchildren	schooolchildren,schoolchildren
oocytes	ooocytes,oocytes
dundee	dundeee,dundee
teeming	teeeming,teeming
bedded	beddded,bedded
escrow	escroww,escrow
fleece	fleeece,fleece
moorish	mooorish,moorish
flowchart	flowwchart,flowchart
beets	beeets,beets
middlemen	midddlemen,middlemen
booksellers	boooksellers,booksellers
hallowed	hallowwed,hallowed
waterproof	waterprooof,waterproof
snows	snowws,snows
nawab	nawwab,nawab
spawn	spawwn,spawn
sleepless	sleeepless,sleepless
lawmakers	lawwmakers,lawmakers
chattanooga	chattanoooga,chattanooga
norwood	norwoood,norwood
plowed	plowwed,plowed
withdraws	withdrawws,withdraws
toothed	tooothed,toothed
growths	growwths,growths
cheeses	cheeeses,cheeses
rupee	rupeee,rupee
bloomfield	blooomfield,bloomfield
breech	breeech,breech
selfhood	selfhoood,selfhood
toolbox	tooolbox,toolbox
sleeper	sleeeper,sleeper
rooster	roooster,rooster
saddled	sadddled,saddled
boosted	booosted,boosted
onlookers	onloookers,onlookers
bookstores	boookstores,bookstores
tween	tweeen,tween
leech	leeech,leech
maastricht	maaastricht,maastricht
eeoc	eeeoc,eeoc
breezes	breeezes,breezes
blackwood	blackwoood,blackwood
assignee	assigneee,assignee
sweetest	sweeetest,sweetest
seaward	seawward,seaward
appointees	appointeees,appointees
foolishly	fooolishly,foolishly
lees	leees,lees
booklets	boooklets,booklets
ruddy	rudddy,ruddy
needful	neeedful,needful
toynbee	toynbeee,toynbee
pee	peee,pee
nationhood	nationhoood,nationhood
hollows	hollowws,hollows
schoolhouse	schooolhouse,schoolhouse
overtook	overtoook,overtook
woodstock	wooodstock,woodstock
faraway	farawway,faraway
upkeep	upkeeep,upkeep
seepage	seeepage,seepage
volunteering	volunteeering,volunteering
sparrows	sparrowws,sparrows
overseeing	overseeeing,overseeing
reeling	reeeling,reeling
freddy	fredddy,freddy
cuckoo	cuckooo,cuckoo
whirlpool	whirlpoool,whirlpool
overseers	overseeers,overseers
reels	reeels,reels
showcase	showwcase,showcase
doorbell	dooorbell,doorbell
lawton	lawwton,lawton
nineteenthcentury	nineteeenthcentury,nineteenthcentury
osgood	osgoood,osgood
oocyte	ooocyte,oocyte
shooter	shoooter,shooter
crowell	crowwell,crowell
dawes	dawwes,dawes
madden	maddden,madden
foreshadowed	foreshadowwed,foreshadowed
goodrich	gooodrich,goodrich
coop	cooop,coop
guidebook	guideboook,guidebook
rowed	rowwed,rowed
seething	seeething,seething
awed	awwed,awed
rowley	rowwley,rowley
lookup	loookup,lookup
goodly	gooodly,goodly
zooplankton	zoooplankton,zooplankton
jamestown	jamestowwn,jamestown
trooper	troooper,trooper
sawdust	sawwdust,sawdust
cracow	cracoww,cracow
hooded	hoooded,hooded
groomed	grooomed,groomed
goodnight	gooodnight,goodnight
cree	creee,cree
rangoon	rangooon,rangoon
yawning	yawwning,yawning
needham	neeedham,needham
steers	steeers,steers
attlee	attleee,attlee
woodwork	wooodwork,woodwork
biddle	bidddle,biddle
fatherhood	fatherhoood,fatherhood
saws	sawws,saws
widower	widowwer,widower
lawlessness	lawwlessness,lawlessness
cherokees	cherokeees,cherokees
retirees	retireees,retirees
sightseeing	sightseeeing,sightseeing
woodruff	wooodruff,woodruff
harrow	harroww,harrow
hodder	hoddder,hodder
riddled	ridddled,riddled
schoolteacher	schooolteacher,schoolteacher
kidd	kiddd,kidd
sweeter	sweeeter,sweeter
bellow	belloww,bellow
freezes	freeezes,freezes
sloop	slooop,sloop
fawn	fawwn,fawn
cowper	cowwper,cowper
floodplain	flooodplain,floodplain
boosting	booosting,boosting
towing	towwing,towing
reeve	reeeve,reeve
streetcar	streeetcar,streetcar
sprawl	sprawwl,sprawl
drowsy	drowwsy,drowsy
payee	payeee,payee
furrows	furrowws,furrows
hawley	hawwley,hawley
saddles	sadddles,saddles
geertz	geeertz,geertz
cools	coools,cools
bidders	biddders,bidders
scarecrow	scarecroww,scarecrow
steed	steeed,steed
puddle	pudddle,puddle
personhood	personhoood,personhood
soothed	sooothed,soothed
downside	dowwnside,downside
dawning	dawwning,dawning
preeminent	preeeminent,preeminent
undergrowth	undergrowwth,undergrowth
giddy	gidddy,giddy
cocoon	cocooon,cocoon
howled	howwled,howled
isaacs	isaaacs,isaacs
freemen	freeemen,freemen
growl	growwl,growl
pyrenees	pyreneees,pyrenees
heeded	heeeded,heeded
schooled	schoooled,schooled
harrowing	harrowwing,harrowing
booze	boooze,booze
sneer	sneeer,sneer
sawmill	sawwmill,sawmill
longstreet	longstreeet,longstreet
beowulf	beowwulf,beowulf
ree	reee,ree
slowdown	slowwdowwn,slowdown
cheerfulness	cheeerfulness,cheerfulness
redrawn	redrawwn,redrawn
adder	addder,adder
hooke	hoooke,hooke
eddies	edddies,eddies
malinowski	malinowwski,malinowski
clowns	clowwns,clowns
preschoolers	preschooolers,preschoolers
eels	eeels,eels
saddened	sadddened,saddened
boomed	booomed,boomed
disallowed	disallowwed,disallowed
bookshop	boookshop,bookshop
middletown	midddletowwn,middletown
crowe	crowwe,crowe
waterfowl	waterfowwl,waterfowl
downturn	dowwnturn,downturn
ludlow	ludloww,ludlow
eerdmans	eeerdmans,eerdmans
sundown	sundowwn,sundown
dragoons	dragooons,dragoons
fiancee	fianceee,fiancee
cauliflower	cauliflowwer,cauliflower
freehold	freeehold,freehold
atwood	atwoood,atwood
moored	mooored,moored
shampoo	shampooo,shampoo
speeded	speeeded,speeded
spool	spoool,spool
looted	loooted,looted
flawless	flawwless,flawless
greenville	greeenville,greenville
cookery	coookery,cookery
unknowable	unknowwable,unknowable
yawned	yawwned,yawned
untoward	untowward,untoward
heywood	heywoood,heywood
mckee	mckeee,mckee
maroon	marooon,maroon
afrikaans	afrikaaans,afrikaans
endow	endoww,endow
gnawing	gnawwing,gnawing
cladding	claddding,cladding
detainees	detaineees,detainees
weekdays	weeekdays,weekdays
budd	buddd,budd
scowled	scowwled,scowled
addams	adddams,addams
lagoons	lagooons,lagoons
bellowed	bellowwed,bellowed
footprint	foootprint,footprint
fooling	foooling,fooling
coo	cooo,coo
leeward	leeeward,leeward
imbedded	imbeddded,imbedded
footer	foooter,footer
waals	waaals,waals
coon	cooon,coon
dowager	dowwager,dowager
neighbourhoods	neighbourhooods,neighbourhoods
tooling	toooling,tooling
knower	knowwer,knower
awkwardness	awwkwardness,awkwardness
seers	seeers,seers
awakens	awwakens,awakens
woolly	wooolly,woolly
boomers	booomers,boomers
prodded	proddded,prodded
cookbook	coookboook,cookbook
loomis	looomis,loomis
ladd	laddd,ladd
inbreeding	inbreeeding,inbreeding
scrapbook	scrapboook,scrapbook
ncaa	ncaaa,ncaa
reestablished	reeestablished,reestablished
afoot	afooot,afoot
levee	leveee,levee
saloons	salooons,saloons
collingwood	collingwoood,collingwood
browned	browwned,browned
grantee	granteee,grantee
trodden	troddden,trodden
narrowness	narrowwness,narrowness
blower	blowwer,blower
fowls	fowwls,fowls
reentry	reeentry,reentry
sneered	sneeered,sneered
toothpaste	tooothpaste,toothpaste
lowercase	lowwercase,lowercase
whooping	whoooping,whooping
downloading	dowwnloading,downloading
downsizing	dowwnsizing,downsizing
muddled	mudddled,muddled
gazetteer	gazetteeer,gazetteer
looped	loooped,looped
disagrees	disagreees,disagrees
shawn	shawwn,shawn
foodgrains	fooodgrains,foodgrains
overpowered	overpowwered,overpowered
shopkeeper	shopkeeeper,shopkeeper
booms	boooms,booms
dower	dowwer,dower
homewood	homewoood,homewood
misdeeds	misdeeeds,misdeeds
goode	gooode,goode
meddling	medddling,meddling
roost	rooost,roost
needlessly	neeedlessly,needlessly
lows	lowws,lows
leeway	leeeway,leeway
creeps	creeeps,creeps
withstood	withstoood,withstood
donee	doneee,donee
innkeeper	innkeeeper,innkeeper
muddle	mudddle,muddle
hawthorn	hawwthorn,hawthorn
puree	pureee,puree
hoops	hooops,hoops
thawing	thawwing,thawing
noose	nooose,noose
addendum	adddendum,addendum
mee	meee,mee
feedings	feeedings,feedings
wheezing	wheeezing,wheezing
mowing	mowwing,mowing
cooperatively	coooperatively,cooperatively
pows	powws,pows
yorktown	yorktowwn,yorktown
bigelow	bigeloww,bigelow
sourcebook	sourceboook,sourcebook
preemptive	preeemptive,preemptive
cottonwood	cottonwoood,cottonwood
coordinators	cooordinators,coordinators
beseech	beseeech,beseech
widowhood	widowwhoood,widowhood
sawing	sawwing,sawing
heeled	heeeled,heeled
hawkes	hawwkes,hawkes
stowed	stowwed,stowed
nook	noook,nook
grooved	groooved,grooved
showdown	showwdowwn,showdown
haw	haww,haw
voodoo	vooodooo,voodoo
colleen	colleeen,colleen
marlow	marloww,marlow
tuskegee	tuskegeee,tuskegee
arrowheads	arrowwheads,arrowheads
mooring	moooring,mooring
uaw	uaww,uaw
arrowhead	arrowwhead,arrowhead
outflows	outflowws,outflows
shuddering	shudddering,shuddering
crooks	croooks,crooks
showy	showwy,showy
hoofs	hooofs,hoofs
mow	moww,mow
nightgown	nightgowwn,nightgown
feebly	feeebly,feebly
preemption	preeemption,preemption
stoddard	stodddard,stoddard
goodyear	gooodyear,goodyear
gawain	gawwain,gawain
stow	stoww,stow
hollowed	hollowwed,hollowed
uptown	uptowwn,uptown
goody	gooody,goody
downed	dowwned,downed
steeple	steeeple,steeple
barrows	barrowws,barrows
looping	loooping,looping
sheehan	sheeehan,sheehan
spreadsheets	spreadsheeets,spreadsheets
middleclass	midddleclass,middleclass
geddes	gedddes,geddes
hoods	hooods,hoods
flowery	flowwery,flowery
mower	mowwer,mower
harwood	harwoood,harwood
reddened	redddened,reddened
bloodless	blooodless,bloodless
mukherjee	mukherjeee,mukherjee
rookie	roookie,rookie
weekday	weeekday,weekday
keene	keeene,keene
tawny	tawwny,tawny
haywood	haywoood,haywood
homeowner	homeowwner,homeowner
sleepers	sleeepers,sleepers
sisterhood	sisterhoood,sisterhood
addictions	adddictions,addictions
townshend	towwnshend,townshend
gaap	gaaap,gaap
speer	speeer,speer
unseemly	unseeemly,unseemly
hawking	hawwking,hawking
greensboro	greeensboro,greensboro
unknowingly	unknowwingly,unknowingly
tallow	talloww,tallow
jigsaw	jigsaww,jigsaw
shallower	shallowwer,shallower
cheery	cheeery,cheery
awry	awwry,awry
livelihoods	livelihooods,livelihoods
toolkit	tooolkit,toolkit
chatterjee	chatterjeee,chatterjee
franchisee	franchiseee,franchisee
loopholes	looopholes,loopholes
yawn	yawwn,yawn
domineering	domineeering,domineering
looser	loooser,looser
ddr	dddr,ddr
thawed	thawwed,thawed
bowler	bowwler,bowler
licensees	licenseees,licensees
burrowing	burrowwing,burrowing
veered	veeered,veered
bootstrap	boootstrap,bootstrap
sweetened	sweeetened,sweetened
underfoot	underfooot,underfoot
darrow	darroww,darrow
woodcock	wooodcock,woodcock
paddling	padddling,paddling
reelected	reeelected,reelected
headdress	headddress,headdress
firepower	firepowwer,firepower
cowards	cowwards,cowards
meekly	meeekly,meekly
berkowitz	berkowwitz,berkowitz
brooch	broooch,brooch
empowers	empowwers,empowers
aas	aaas,aas
maddox	madddox,maddox
woodcut	wooodcut,woodcut
shadowing	shadowwing,shadowing
lansdowne	lansdowwne,lansdowne
threedimensional	threeedimensional,threedimensional
kilowatt	kilowwatt,kilowatt
peerage	peeerage,peerage
wedgwood	wedgwoood,wedgwood
choctaw	choctaww,choctaw
soo	sooo,soo
stooping	stoooping,stooping
followup	followwup,followup
greenery	greeenery,greenery
croom	crooom,croom
touchdown	touchdowwn,touchdown
unlawfully	unlawwfully,unlawfully
coombs	cooombs,coombs
pooh	poooh,pooh
rowdy	rowwdy,rowdy
baboons	babooons,baboons
offshoot	offshooot,offshoot
hardwoods	hardwooods,hardwoods
preeminence	preeeminence,preeminence
agreeably	agreeeably,agreeably
bowlby	bowwlby,bowlby
prodding	proddding,prodding
bookcase	boookcase,bookcase
klee	kleee,klee
meer	meeer,meer
bookkeeper	boookkeeeper,bookkeeper
toothbrush	tooothbrush,toothbrush
paddock	padddock,paddock
cheddar	chedddar,cheddar
bowden	bowwden,bowden
knowable	knowwable,knowable
aan	aaan,aan
warszawa	warszawwa,warszawa
tallahassee	tallahasseee,tallahassee
growling	growwling,growling
bloomsbury	blooomsbury,bloomsbury
freemasonry	freeemasonry,freemasonry
reexamination	reeexamination,reexamination
paddles	padddles,paddles
towered	towwered,towered
heen	heeen,heen
cheekbones	cheeekbones,cheekbones
hawke	hawwke,hawke
knighthood	knighthoood,knighthood
narrowest	narrowwest,narrowest
entree	entreee,entree
outgrown	outgrowwn,outgrown
shawnee	shawwneee,shawnee
loon	looon,loon
peeping	peeeping,peeping
bestows	bestowws,bestows
hathaway	hathawway,hathaway
linseed	linseeed,linseed
adductor	addductor,adductor
dowling	dowwling,dowling
furrowed	furrowwed,furrowed
straws	strawws,straws
coolies	cooolies,coolies
woodpecker	wooodpecker,woodpecker
banerjee	banerjeee,banerjee
peeked	peeeked,peeked
mayflower	mayflowwer,mayflower
mistook	mistoook,mistook
rhee	rheee,rhee
baboon	babooon,baboon
slowest	slowwest,slowest
oozing	ooozing,oozing
proofreading	prooofreading,proofreading
canaanite	canaaanite,canaanite
peshawar	peshawwar,peshawar
greets	greeets,greets
middling	midddling,middling
sows	sowws,sows
wooing	woooing,wooing
spree	spreee,spree
inlaw	inlaww,inlaw
unacknowledged	unacknowwledged,unacknowledged
kalamazoo	kalamazooo,kalamazoo
huddle	hudddle,huddle
dawkins	dawwkins,dawkins
powdery	powwdery,powdery
aachen	aaachen,aachen
appellee	appelleee,appellee
auctioneer	auctioneeer,auctioneer
loosed	looosed,loosed
wildflowers	wildflowwers,wildflowers
hoo	hooo,hoo
kee	keee,kee
rowman	rowwman,rowman
overflowed	overflowwed,overflowed
rostow	rostoww,rostow
needlework	neeedlework,needlework
footman	foootman,footman
snowfall	snowwfall,snowfall
screeching	screeeching,screeching
tattooed	tattoooed,tattooed
scowl	scowwl,scowl
moonlit	mooonlit,moonlit
overridden	overriddden,overridden
sawed	sawwed,sawed
yellows	yellowws,yellows
seep	seeep,seep
deepens	deeepens,deepens
fiddler	fidddler,fiddler
bestowing	bestowwing,bestowing
cooker	coooker,cooker
schoolroom	schooolrooom,schoolroom
noaa	noaaa,noaa
meddle	medddle,meddle
sowie	sowwie,sowie
towne	towwne,towne
liddell	lidddell,liddell
toolbars	tooolbars,toolbars
shipowners	shipowwners,shipowners
reeled	reeeled,reeled
shallows	shallowws,shallows
woodworking	wooodworking,woodworking
cooh	coooh,cooh
knowledges	knowwledges,knowledges
greenspan	greeenspan,greenspan
raccoon	raccooon,raccoon
snowball	snowwball,snowball
referees	refereees,referees
clawed	clawwed,clawed
downcast	dowwncast,downcast
sodden	soddden,sodden
middleman	midddleman,middleman
reevaluation	reeevaluation,reevaluation
brownian	browwnian,brownian
downey	dowwney,downey
tattoos	tattooos,tattoos
puddles	pudddles,puddles
microorganism	microoorganism,microorganism
lookin	loookin,lookin
screech	screeech,screech
reengineering	reeengineeering,reengineering
shipowner	shipowwner,shipowner
groot	grooot,groot
moorings	mooorings,moorings
brownsville	browwnsville,brownsville
doo	dooo,doo
squaw	squaww,squaw
keenan	keeenan,keenan
woodbury	wooodbury,woodbury
doolittle	dooolittle,doolittle
holbrook	holbroook,holbrook
rooney	roooney,rooney
attendees	attendeees,attendees
typhoon	typhooon,typhoon
uncooperative	uncoooperative,uncooperative
flees	fleees,flees
overgrowth	overgrowwth,overgrowth
storeroom	storerooom,storeroom
dooley	doooley,dooley
suddenness	sudddenness,suddenness
braddock	bradddock,braddock
swoop	swooop,swoop
veer	veeer,veer
keener	keeener,keener
heedless	heeedless,heedless
straddle	stradddle,straddle
townsmen	towwnsmen,townsmen
runaways	runawways,runaways
magee	mageee,magee
apogee	apogeee,apogee
rooftop	roooftop,rooftop
moo	mooo,moo
privateers	privateeers,privateers
downy	dowwny,downy
ghee	gheee,ghee
goodies	gooodies,goodies
gleefully	gleeefully,gleefully
flywheel	flywheeel,flywheel
sheeting	sheeeting,sheeting
zoos	zooos,zoos
eighteenthcentury	eighteeenthcentury,eighteenthcentury
bookmark	boookmark,bookmark
oddity	odddity,oddity
prow	proww,prow
sneezing	sneeezing,sneezing
shootings	shoootings,shootings
caa	caaa,caa
lightfoot	lightfooot,lightfoot
bool	boool,bool
brookes	broookes,brookes
woodbridge	wooodbridge,woodbridge
swooped	swoooped,swooped
patentee	patenteee,patentee
paddled	padddled,paddled
freestanding	freeestanding,freestanding
dowel	dowwel,dowel
maw	maww,maw
mountaineers	mountaineeers,mountaineers
selfesteem	selfesteeem,selfesteem
lawler	lawwler,lawler
billowing	billowwing,billowing
zee	zeee,zee
idee	ideee,idee
scrawled	scrawwled,scrawled
beaverbrook	beaverbroook,beaverbrook
reexamine	reeexamine,reexamine
gatekeeper	gatekeeeper,gatekeeper
hawaiians	hawwaiians,hawaiians
woodhouse	wooodhouse,woodhouse
downwind	dowwnwind,downwind
subcommittees	subcommitteees,subcommittees
charlestown	charlestowwn,charlestown
beep	beeep,beep
peddlers	pedddlers,peddlers
unawares	unawwares,unawares
bradstreet	bradstreeet,bradstreet
foolhardy	fooolhardy,foolhardy
marquee	marqueee,marquee
bungalows	bungalowws,bungalows
casebook	caseboook,casebook
sweetie	sweeetie,sweetie
maddening	madddening,maddening
eastwood	eastwoood,eastwood
saar	saaar,saar
bluetooth	bluetoooth,bluetooth
outlooks	outloooks,outlooks
iaa	iaaa,iaa
seeped	seeeped,seeped
bloodthirsty	blooodthirsty,bloodthirsty
aloofness	alooofness,aloofness
sowed	sowwed,sowed
brawl	brawwl,brawl
breen	breeen,breen
chinook	chinoook,chinook
toothache	tooothache,toothache
thaddeus	thadddeus,thaddeus
pawnee	pawwneee,pawnee
rood	roood,rood
footpath	foootpath,footpath
kuwaiti	kuwwaiti,kuwaiti
doorman	dooorman,doorman
overthrowing	overthrowwing,overthrowing
evergreens	evergreeens,evergreens
loophole	looophole,loophole
schoolwork	schooolwork,schoolwork
shoddy	shodddy,shoddy
greener	greeener,greener
glows	glowws,glows
adduction	addduction,adduction
waddell	wadddell,waddell
queene	queeene,queene
shawls	shawwls,shawls
ooze	oooze,ooze
sawn	sawwn,sawn
downtrodden	dowwntroddden,downtrodden
greenpeace	greeenpeace,greenpeace
downpour	dowwnpour,downpour
threes	threees,threes
sleeved	sleeeved,sleeved
snowstorm	snowwstorm,snowstorm
dodds	doddds,dodds
greenhouses	greeenhouses,greenhouses
bloomed	blooomed,bloomed
peddler	pedddler,peddler
woodcuts	wooodcuts,woodcuts
awash	awwash,awash
mcgowan	mcgowwan,mcgowan
brookfield	broookfield,brookfield
doreen	doreeen,doreen
rook	roook,rook
oversaw	oversaww,oversaw
krakow	krakoww,krakow
owne	owwne,owne
armageddon	armagedddon,armageddon
grooms	groooms,grooms
bowker	bowwker,bowker
gloomily	glooomily,gloomily
midden	middden,midden
plows	plowws,plows
willpower	willpowwer,willpower
howie	howwie,howie
goddamned	godddamned,goddamned
greedily	greeedily,greedily
preempted	preeempted,preempted
oversees	overseees,oversees
hobsbawm	hobsbawwm,hobsbawm
pawns	pawwns,pawns
mcgrawhill	mcgrawwhill,mcgrawhill
overflows	overflowws,overflows
straddling	stradddling,straddling
foreshadowing	foreshadowwing,foreshadowing
weevil	weeevil,weevil
rosewood	rosewoood,rosewood
cee	ceee,cee
boosters	booosters,boosters
deere	deeere,deere
kawasaki	kawwasaki,kawasaki
sleet	sleeet,sleet
downtime	dowwntime,downtime
crawley	crawwley,crawley
chee	cheee,chee
brownell	browwnell,brownell
rooftops	roooftops,rooftops
yee	yeee,yee
spoonful	spooonful,spoonful
cartoonist	cartooonist,cartoonist
bittersweet	bittersweeet,bittersweet
booby	boooby,booby
seeping	seeeping,seeping
showroom	showwrooom,showroom
broods	brooods,broods
saddest	sadddest,saddest
uncoordinated	uncooordinated,uncoordinated
overshoot	overshooot,overshoot
beehive	beeehive,beehive
workbooks	workboooks,workbooks
plodding	ploddding,plodding
naa	naaa,naa
droop	drooop,droop
yaw	yaww,yaw
woolley	wooolley,woolley
rudd	ruddd,rudd
rainbows	rainbowws,rainbows
roos	rooos,roos
disagreeing	disagreeeing,disagreeing
howls	howwls,howls
pocketbook	pocketboook,pocketbook
addie	adddie,addie
reproof	reprooof,reproof
driftwood	driftwoood,driftwood
meekness	meeekness,meekness
scowling	scowwling,scowling
gatekeepers	gatekeeepers,gatekeepers
freehand	freeehand,freehand
yarrow	yarroww,yarrow
crowther	crowwther,crowther
redding	reddding,redding
loos	looos,loos
middleware	midddleware,middleware
prowling	prowwling,prowling
drawled	drawwled,drawled
westwood	westwoood,westwood
steely	steeely,steely
harpoon	harpooon,harpoon
mawr	mawwr,mawr
foreknowledge	foreknowwledge,foreknowledge
unheeded	unheeeded,unheeded
weeps	weeeps,weeps
fiddling	fidddling,fiddling
forenoon	forenooon,forenoon
prawns	prawwns,prawns
girlhood	girlhoood,girlhood
goodall	gooodall,goodall
kiowa	kiowwa,kiowa
woodman	wooodman,woodman
agee	ageee,agee
platoons	platooons,platoons
sleepiness	sleeepiness,sleepiness
sneeze	sneeeze,sneeze
newsroom	newsrooom,newsroom
appointee	appointeee,appointee
scooter	scoooter,scooter
overshadow	overshadoww,overshadow
brownie	browwnie,brownie
brooded	broooded,brooded
wheelchairs	wheeelchairs,wheelchairs
darkroom	darkrooom,darkroom
levees	leveees,levees
microwaves	microwwaves,microwaves
goodenough	gooodenough,goodenough
bawdy	bawwdy,bawdy
footings	foootings,footings
melee	meleee,melee
blackfoot	blackfooot,blackfoot
woodson	wooodson,woodson
uw	uww,uw
bookshelves	boookshelves,bookshelves
greening	greeening,greening
powerhouse	powwerhouse,powerhouse
seeger	seeeger,seeger
bookmarks	boookmarks,bookmarks
coolie	cooolie,coolie
steelworkers	steeelworkers,steelworkers
falsehoods	falsehooods,falsehoods
storekeeper	storekeeeper,storekeeper
getaway	getawway,getaway
waa	waaa,waa
bellowing	bellowwing,bellowing
freetown	freeetowwn,freetown
maas	maaas,maas
maccabees	maccabeees,maccabees
poodle	pooodle,poodle
vee	veee,vee
lawmaking	lawwmaking,lawmaking
booted	boooted,booted
jeeps	jeeeps,jeeps
haarlem	haaarlem,haarlem
naw	naww,naw
hoot	hooot,hoot
midtown	midtowwn,midtown
rundown	rundowwn,rundown
gnawed	gnawwed,gnawed
indiscreet	indiscreeet,indiscreet
leeches	leeeches,leeches
freeport	freeeport,freeport
greenleaf	greeenleaf,greenleaf
hooking	hoooking,hooking
landowning	landowwning,landowning
backwoods	backwooods,backwoods
kidder	kiddder,kidder
poop	pooop,poop
sandalwood	sandalwoood,sandalwood
goo	gooo,goo
checkbook	checkboook,checkbook
sheepishly	sheeepishly,sheepishly
rawlings	rawwlings,rawlings
drooped	droooped,drooped
kirkwood	kirkwoood,kirkwood
awning	awwning,awning
peddling	pedddling,peddling
bloods	blooods,bloods
ioo	iooo,ioo
aimee	aimeee,aimee
noonday	nooonday,noonday
mcfadden	mcfaddden,mcfadden
breezy	breeezy,breezy
wheelbarrow	wheeelbarroww,wheelbarrow
showering	showwering,showering
doorknob	dooorknob,doorknob
softwood	softwoood,softwood
aladdin	aladddin,aladdin
schoolboys	schooolboys,schoolboys
waddington	wadddington,waddington
mountaineering	mountaineeering,mountaineering
rooming	roooming,rooming
sooty	soooty,sooty
vermeer	vermeeer,vermeer
snowden	snowwden,snowden
boomer	booomer,boomer
airspeed	airspeeed,airspeed
roommates	rooommates,roommates
sallow	salloww,sallow
maddie	madddie,maddie
snowing	snowwing,snowing
cowles	cowwles,cowles
creepy	creeepy,creepy
bookshelf	boookshelf,bookshelf
paddington	padddington,paddington
entrees	entreees,entrees
consignee	consigneee,consignee
noodle	nooodle,noodle
paratroopers	paratrooopers,paratroopers
seedy	seeedy,seedy
tycoon	tycooon,tycoon
bassoon	bassooon,bassoon
tees	teees,tees
overpower	overpowwer,overpower
avowedly	avowwedly,avowedly
toothless	tooothless,toothless
reexamined	reeexamined,reexamined
steen	steeen,steen
foo	fooo,foo
greenblatt	greeenblatt,greenblatt
totowa	totowwa,totowa
shooters	shoooters,shooters
stanislaw	stanislaww,stanislaw
bowery	bowwery,bowery
foolproof	fooolprooof,foolproof
hawes	hawwes,hawes
solow	soloww,solow
peeped	peeeped,peeped
mutineers	mutineeers,mutineers
leer	leeer,leer
unfeeling	unfeeeling,unfeeling
hydropower	hydropowwer,hydropower
tomahawk	tomahawwk,tomahawk
pharisee	phariseee,pharisee
crackdown	crackdowwn,crackdown
sulawesi	sulawwesi,sulawesi
snowflakes	snowwflakes,snowflakes
staat	staaat,staat
toothpick	tooothpick,toothpick
keegan	keeegan,keegan
plowman	plowwman,plowman
kraal	kraaal,kraal
schoolgirl	schooolgirl,schoolgirl
bowes	bowwes,bowes
bataan	bataaan,bataan
bailee	baileee,bailee
bookings	boookings,bookings
sassoon	sassooon,sassoon
rawlinson	rawwlinson,rawlinson
reevaluate	reeevaluate,reevaluate
oddities	odddities,oddities
maasai	maaasai,maasai
eddington	edddington,eddington
yellowing	yellowwing,yellowing
hawker	hawwker,hawker
baa	baaa,baa
cowed	cowwed,cowed
peeking	peeeking,peeking
saa	saaa,saa
screeched	screeeched,screeched
spooner	spoooner,spooner
disowned	disowwned,disowned
franchisees	franchiseees,franchisees
boomerang	booomerang,boomerang
doomsday	dooomsday,doomsday
uncooked	uncoooked,uncooked
cameroons	camerooons,cameroons
floored	flooored,floored
beebe	beeebe,beebe
downriver	dowwnriver,downriver
safekeeping	safekeeeping,safekeeping
schoolteachers	schooolteachers,schoolteachers
ridding	riddding,ridding
preempt	preeempt,preempt
keeler	keeeler,keeler
maddy	madddy,maddy
haddock	hadddock,haddock
lawgiver	lawwgiver,lawgiver
dogwood	dogwoood,dogwood
proofing	prooofing,proofing
freeholders	freeeholders,freeholders
leeks	leeeks,leeks
noonan	nooonan,noonan
scrooge	scroooge,scrooge
caddy	cadddy,caddy
uprooting	uproooting,uprooting
guidebooks	guideboooks,guidebooks
skidded	skiddded,skidded
broome	brooome,broome
peerless	peeerless,peerless
onlooker	onloooker,onlooker
reece	reeece,reece
cottonseed	cottonseeed,cottonseed
leek	leeek,leek
tuscaloosa	tuscalooosa,tuscaloosa
spooky	spoooky,spooky
downes	dowwnes,downes
schooners	schoooners,schooners
yahoo	yahooo,yahoo
dawns	dawwns,dawns
haag	haaag,haag
frowns	frowwns,frowns
regrowth	regrowwth,regrowth
restroom	restrooom,restroom
subtree	subtreee,subtree
looseness	loooseness,looseness
recordkeeping	recordkeeeping,recordkeeping
balaam	balaaam,balaam
coworker	cowworker,coworker
rawson	rawwson,rawson
billows	billowws,billows
floorboards	flooorboards,floorboards
ishikawa	ishikawwa,ishikawa
reenter	reeenter,reenter
sawmills	sawwmills,sawmills
mowbray	mowwbray,mowbray
matinee	matineee,matinee
blowers	blowwers,blowers
aiaa	aiaaa,aiaa
seeley	seeeley,seeley
kneels	kneeels,kneels
zeeman	zeeeman,zeeman
cowell	cowwell,cowell
breakaway	breakawway,breakaway
moorland	mooorland,moorland
isherwood	isherwoood,isherwood
weeklies	weeeklies,weeklies
rowell	rowwell,rowell
murrow	murroww,murrow
steepest	steeepest,steepest
goddam	godddam,goddam
bleeds	bleeeds,bleeds
soweto	sowweto,soweto
bidden	biddden,bidden
bazaars	bazaaars,bazaars
redeemable	redeeemable,redeemable
doodle	dooodle,doodle
cocoons	cocooons,cocoons
wroclaw	wroclaww,wroclaw
dowd	dowwd,dowd
straightaway	straightawway,straightaway
reestablishment	reeestablishment,reestablishment
schoolmasters	schooolmasters,schoolmasters
roo	rooo,roo
windowless	windowwless,windowless
newsreel	newsreeel,newsreel
disavowed	disavowwed,disavowed
examinee	examineee,examinee
feedstock	feeedstock,feedstock
internees	interneees,internees
saginaw	saginaww,saginaw
windowsill	windowwsill,windowsill
howland	howwland,howland
hedda	heddda,hedda
howes	howwes,howes
preeclampsia	preeeclampsia,preeclampsia
watertown	watertowwn,watertown
koo	kooo,koo
scrawny	scrawwny,scrawny
whoop	whooop,whoop
fuelwood	fuelwoood,fuelwood
trawl	trawwl,trawl
enrollees	enrolleees,enrollees
albee	albeee,albee
creeper	creeeper,creeper
brouwer	brouwwer,brouwer
handloom	handlooom,handloom
mcqueen	mcqueeen,mcqueen
freemasons	freeemasons,freemasons
partook	partoook,partook
countdown	countdowwn,countdown
woodford	wooodford,woodford
lawes	lawwes,lawes
darjeeling	darjeeeling,darjeeling
tattooing	tattoooing,tattooing
freeways	freeeways,freeways
restrooms	restroooms,restrooms
giddings	gidddings,giddings
sadder	saddder,sadder
outlawing	outlawwing,outlawing
bloodied	blooodied,bloodied
rawhide	rawwhide,rawhide
witherspoon	witherspooon,witherspoon
feedforward	feeedforward,feedforward
steepness	steeepness,steepness
lowenthal	lowwenthal,lowenthal
wooed	woooed,wooed
youngstown	youngstowwn,youngstown
jowett	jowwett,jowett
unknowing	unknowwing,unknowing
brooms	broooms,brooms
drawdown	drawwdowwn,drawdown
bookshops	boookshops,bookshops
drawl	drawwl,drawl
sneering	sneeering,sneering
coopers	cooopers,coopers
reedy	reeedy,reedy
steeds	steeeds,steeds
zooming	zoooming,zooming
peels	peeels,peels
brower	browwer,brower
trowel	trowwel,trowel
downplay	dowwnplay,downplay
screenwriter	screeenwriter,screenwriter
privateer	privateeer,privateer
treetops	treeetops,treetops
saskatoon	saskatooon,saskatoon
snowed	snowwed,snowed
mowed	mowwed,mowed
crawls	crawwls,crawls
blackfeet	blackfeeet,blackfeet
clawing	clawwing,clawing
brotherhoods	brotherhooods,brotherhoods
downloads	dowwnloads,downloads
sadducees	saddduceees,sadducees
beeswax	beeeswax,beeswax
tooke	toooke,tooke
lessees	lesseees,lessees
poore	pooore,poore
straddled	stradddled,straddled
wheelwright	wheeelwright,wheelwright
thrower	throwwer,thrower
sheepskin	sheeepskin,sheepskin
bedridden	bedriddden,bedridden
aad	aaad,aad
treeless	treeeless,treeless
keenest	keeenest,keenest
squeezes	squeeezes,squeezes
reddening	redddening,reddening
bloodshot	blooodshot,bloodshot
creel	creeel,creel
foreshadows	foreshadowws,foreshadows
seaway	seawway,seaway
puddings	pudddings,puddings
canteens	canteeens,canteens
adduce	addduce,adduce
pedigrees	pedigreees,pedigrees
shee	sheee,shee
mooted	moooted,mooted
dde	ddde,dde
rowena	rowwena,rowena
endows	endowws,endows
roomy	rooomy,roomy
showman	showwman,showman
gooch	goooch,gooch
rabinowitz	rabinowwitz,rabinowitz
adducts	addducts,adducts
tawney	tawwney,tawney
coolers	cooolers,coolers
oilseeds	oilseeeds,oilseeds
powhatan	powwhatan,powhatan
offeree	offereee,offeree
knoweth	knowweth,knoweth
cheeked	cheeeked,cheeked
sunflowers	sunflowwers,sunflowers
greenstone	greeenstone,greenstone
westbrook	westbroook,westbrook
woolworth	wooolworth,woolworth
beecham	beeecham,beecham
footmen	foootmen,footmen
wallow	walloww,wallow
fleetwood	fleeetwoood,fleetwood
germantown	germantowwn,germantown
mountaineer	mountaineeer,mountaineer
returnees	returneees,returnees
chickasaw	chickasaww,chickasaw
biweekly	biweeekly,biweekly
scudder	scuddder,scudder
weedy	weeedy,weedy
screenings	screeenings,screenings
disavowal	disavowwal,disavowal
pontoon	pontooon,pontoon
rawlins	rawwlins,rawlins
rowntree	rowwntreee,rowntree
moonshine	mooonshine,moonshine
settee	setteee,settee
sunscreen	sunscreeen,sunscreen
vendee	vendeee,vendee
neel	neeel,neel
seafloor	seaflooor,seafloor
adduct	addduct,adduct
sweeper	sweeeper,sweeper
lowenstein	lowwenstein,lowenstein
trawlers	trawwlers,trawlers
hetween	hetweeen,hetween
canaanites	canaaanites,canaanites
kowloon	kowwlooon,kowloon
crowing	crowwing,crowing
grantees	granteees,grantees
quickbooks	quickboooks,quickbooks
kowalski	kowwalski,kowalski
swoon	swooon,swoon
maa	maaa,maa
brownies	browwnies,brownies
paa	paaa,paa
zoologist	zooologist,zoologist
bristow	bristoww,bristow
udder	uddder,udder
sweeteners	sweeeteners,sweeteners
uproot	uprooot,uproot
nauvoo	nauvooo,nauvoo
kilowatts	kilowwatts,kilowatts
boogie	booogie,boogie
yellowed	yellowwed,yellowed
elwood	elwoood,elwood
prowl	prowwl,prowl
wallowing	wallowwing,wallowing
conferees	confereees,conferees
meerut	meeerut,meerut
foreseeing	foreseeeing,foreseeing
townsfolk	towwnsfolk,townsfolk
rickshaw	rickshaww,rickshaw
nowak	nowwak,nowak
kangaroos	kangarooos,kangaroos
strawson	strawwson,strawson
sauteed	sauteeed,sauteed
tweezers	tweeezers,tweezers
madder	maddder,madder
ogawa	ogawwa,ogawa
haddon	hadddon,haddon
jeered	jeeered,jeered
musketeers	musketeeers,musketeers
kershaw	kershaww,kershaw
haddad	hadddad,haddad
neely	neeely,neely
yearbooks	yearboooks,yearbooks
eerily	eeerily,eerily
schoolmates	schooolmates,schoolmates
offshoots	offshooots,offshoots
wooster	woooster,wooster
proofread	prooofread,proofread
howitzers	howwitzers,howitzers
callaway	callawway,callaway
knowest	knowwest,knowest
deerfield	deeerfield,deerfield
embeddedness	embedddedness,embeddedness
bamboos	bambooos,bamboos
barefooted	barefoooted,barefooted
unfree	unfreee,unfree
workweek	workweeek,workweek
bookish	boookish,bookish
chowder	chowwder,chowder
brooches	broooches,brooches
greenwald	greeenwald,greenwald
dragoon	dragooon,dragoon
moos	mooos,moos
zoomed	zooomed,zoomed
disavow	disavoww,disavow
brookhaven	broookhaven,brookhaven
disallow	disalloww,disallow
boardroom	boardrooom,boardroom
appellees	appelleees,appellees
cooney	coooney,cooney
crenshaw	crenshaww,crenshaw
maddened	madddened,maddened
heathrow	heathroww,heathrow
seeps	seeeps,seeps
mcadoo	mcadooo,mcadoo
aileen	aileeen,aileen
endowing	endowwing,endowing
datasheet	datasheeet,datasheet
keenness	keeenness,keenness
avowal	avowwal,avowal
crowder	crowwder,crowder
knowlton	knowwlton,knowlton
eea	eeea,eea
enfeebled	enfeeebled,enfeebled
profiteering	profiteeering,profiteering
knowed	knowwed,knowed
woof	wooof,woof
addr	adddr,addr
woolwich	wooolwich,woolwich
sawtooth	sawwtoooth,sawtooth
sleeplessness	sleeeplessness,sleeplessness
outgrow	outgroww,outgrow
vallee	valleee,vallee
festooned	festoooned,festooned
heeding	heeeding,heeding
bowdoin	bowwdoin,bowdoin
hartree	hartreee,hartree
poo	pooo,poo
pensee	penseee,pensee
widowers	widowwers,widowers
retiree	retireee,retiree
commandeered	commandeeered,commandeered
heer	heeer,heer
provincetown	provincetowwn,provincetown
sketchbook	sketchboook,sketchbook
sleepily	sleeepily,sleepily
genesee	geneseee,genesee
drawee	drawweee,drawee
landownership	landowwnership,landownership
reestablishing	reeestablishing,reestablishing
foresees	foreseees,foresees
scooping	scoooping,scooping
onscreen	onscreeen,onscreen
cowen	cowwen,cowen
crabtree	crabtreee,crabtree
overseen	overseeen,overseen
peachtree	peachtreee,peachtree
haraway	harawway,haraway
lowing	lowwing,lowing
swooping	swoooping,swooping
hawkers	hawwkers,hawkers
charioteer	charioteeer,charioteer
aac	aaac,aac
awa	awwa,awa
creepers	creeepers,creepers
cowering	cowwering,cowering
scoops	scooops,scoops
hedgerows	hedgerowws,hedgerows
yoo	yooo,yoo
peebles	peeebles,peebles
meeker	meeeker,meeker
addenda	adddenda,addenda
boosts	booosts,boosts
downe	dowwne,downe
racketeering	racketeeering,racketeering
virchow	virchoww,virchow
riddell	ridddell,riddell
reenactment	reeenactment,reenactment
cooing	coooing,cooing
bookcases	boookcases,bookcases
cookbooks	coookboooks,cookbooks
raccoons	raccooons,raccoons
choo	chooo,choo
drooling	droooling,drooling
sweetener	sweeetener,sweetener
addington	adddington,addington
buddhahood	budddhahoood,buddhahood
unforeseeable	unforeseeeable,unforeseeable
forsook	forsoook,forsook
haar	haaar,haar
crowed	crowwed,crowed
disown	disowwn,disown
mudd	muddd,mudd
bawling	bawwling,bawling
electioneering	electioneeering,electioneering
minkowski	minkowwski,minkowski
hindoo	hindooo,hindoo
sweeten	sweeeten,sweeten
cowl	cowwl,cowl
cooperates	coooperates,cooperates
fddi	fdddi,fddi
waal	waaal,waal
sheepish	sheeepish,sheepish
lifeblood	lifebloood,lifeblood
tawdry	tawwdry,tawdry
trowbridge	trowwbridge,trowbridge
morristown	morristowwn,morristown
paddies	padddies,paddies
prawn	prawwn,prawn
oops	ooops,oops
armee	armeee,armee
woolsey	wooolsey,woolsey
bookman	boookman,bookman
beseeching	beseeeching,beseeching
cheesecake	cheeesecake,cheesecake
howarth	howwarth,howarth
goofy	gooofy,goofy
daw	daww,daw
brownlow	browwnloww,brownlow
awl	awwl,awl
bulawayo	bulawwayo,bulawayo
woodworth	wooodworth,woodworth
lawfulness	lawwfulness,lawfulness
soothingly	sooothingly,soothingly
naar	naaar,naar
brookline	broookline,brookline
filigree	filigreee,filigree
sweethearts	sweeethearts,sweethearts
oozed	ooozed,oozed
wormwood	wormwoood,wormwood
townhouse	towwnhouse,townhouse
evacuees	evacueees,evacuees
nooks	noooks,nooks
skidding	skiddding,skidding
hasegawa	hasegawwa,hasegawa
teething	teeething,teething
siddhartha	sidddhartha,siddhartha
speedup	speeedup,speedup
heirloom	heirlooom,heirloom
iee	ieee,iee
trawler	trawwler,trawler
greenway	greeenway,greenway
scheer	scheeer,scheer
playroom	playrooom,playroom
reeking	reeeking,reeking
seddon	sedddon,seddon
sheed	sheeed,sheed
newtown	newtowwn,newtown
interbedded	interbeddded,interbedded
ddc	dddc,ddc
woodpeckers	wooodpeckers,woodpeckers
cheerleader	cheeerleader,cheerleader
cheetah	cheeetah,cheetah
bloodstained	blooodstained,bloodstained
neem	neeem,neem
loosing	looosing,loosing
buccaneers	buccaneeers,buccaneers
weeded	weeeded,weeded
behooves	behoooves,behooves
veering	veeering,veering
minnow	minnoww,minnow
cheever	cheeever,cheever
downgraded	dowwngraded,downgraded
roddy	rodddy,roddy
whitelaw	whitelaww,whitelaw
mellowed	mellowwed,mellowed
snooping	snoooping,snooping
bowled	bowwled,bowled
woodwind	wooodwind,woodwind
vowing	vowwing,vowing
downplayed	dowwnplayed,downplayed
wheelock	wheeelock,wheelock
hankow	hankoww,hankow
rootless	roootless,rootless
sweepstakes	sweeepstakes,sweepstakes
ooh	oooh,ooh
sleeveless	sleeeveless,sleeveless
winnowing	winnowwing,winnowing
anteroom	anterooom,anteroom
crossbow	crossboww,crossbow
mohawks	mohawwks,mohawks
aglow	agloww,aglow
edd	eddd,edd
howitzer	howwitzer,howitzer
hookworm	hoookworm,hookworm
farrow	farroww,farrow
biddy	bidddy,biddy
aarhus	aaarhus,aarhus
redder	reddder,redder
streetcars	streeetcars,streetcars
maroons	marooons,maroons
sower	sowwer,sower
haan	haaan,haan
blackpool	blackpoool,blackpool
minnows	minnowws,minnows
downers	dowwners,downers
soong	sooong,soong
seaweeds	seawweeeds,seaweeds
muldoon	muldooon,muldoon
motown	motowwn,motown
stoops	stooops,stoops
streeter	streeeter,streeter
westlaw	westlaww,westlaw
bree	breee,bree
nowell	nowwell,nowell
reenacted	reeenacted,reenacted
foreshadow	foreshadoww,foreshadow
steerage	steeerage,steerage
workroom	workrooom,workroom
footers	foooters,footers
markowitz	markowwitz,markowitz
drawbridge	drawwbridge,drawbridge
windscreen	windscreeen,windscreen
biilow	biiloww,biilow
lowndes	lowwndes,lowndes
fireproof	fireprooof,fireproof
shallowness	shallowwness,shallowness
meehan	meeehan,meehan
sweepers	sweeepers,sweepers
keefe	keeefe,keefe
browder	browwder,browder
unsweetened	unsweeetened,unsweetened
toddy	todddy,toddy
moskowitz	moskowwitz,moskowitz
plodded	ploddded,plodded
snowflake	snowwflake,snowflake
mcphee	mcpheee,mcphee
downslope	dowwnslope,downslope
seventeenthcentury	seventeeenthcentury,seventeenthcentury
snowman	snowwman,snowman
bladders	bladdders,bladders
unbeknownst	unbeknowwnst,unbeknownst
deadwood	deadwoood,deadwood
coolest	cooolest,coolest
unbidden	unbiddden,unbidden
reboot	rebooot,reboot
lowincome	lowwincome,lowincome
assessee	assesseee,assessee
foodstuff	fooodstuff,foodstuff
feelers	feeelers,feelers
brownstone	browwnstone,brownstone
lowery	lowwery,lowery
additivity	addditivity,additivity
wicklow	wickloww,wicklow
floodplains	flooodplains,floodplains
meese	meeese,meese
thurgood	thurgoood,thurgood
hooted	hoooted,hooted
forefoot	forefooot,forefoot
geer	geeer,geer
brownson	browwnson,brownson
gnaw	gnaww,gnaw
flowcharts	flowwcharts,flowcharts
deepwater	deeepwater,deepwater
teaspoonful	teaspooonful,teaspoonful
buddhi	budddhi,buddhi
aarp	aaarp,aarp
baddeley	badddeley,baddeley
rooks	roooks,rooks
yazoo	yazooo,yazoo
jeering	jeeering,jeering
redwoods	redwooods,redwoods
scrapbooks	scrapboooks,scrapbooks
rawalpindi	rawwalpindi,rawalpindi
footpaths	foootpaths,footpaths
reentered	reeentered,reentered
footstool	foootstoool,footstool
marooned	maroooned,marooned
kneeled	kneeeled,kneeled
agrawal	agrawwal,agrawal
showalter	showwalter,showalter
spook	spoook,spook
gladden	gladdden,gladden
desiree	desireee,desiree
greenstein	greeenstein,greenstein
fleetingly	fleeetingly,fleetingly
washroom	washrooom,washroom
powys	powwys,powys
callow	calloww,callow
springsteen	springsteeen,springsteen
scooted	scoooted,scooted
calloway	callowway,calloway
ood	oood,ood
aaf	aaaf,aaf
grimshaw	grimshaww,grimshaw
examinees	examineees,examinees
bloomer	blooomer,bloomer
redraw	redraww,redraw
adoptees	adopteees,adoptees
toot	tooot,toot
ellwood	ellwoood,ellwood
hiawatha	hiawwatha,hiawatha
poughkeepsie	poughkeeepsie,poughkeepsie
sheehy	sheeehy,sheehy
repartee	reparteee,repartee
dds	ddds,dds
steelhead	steeelhead,steelhead
rowboat	rowwboat,rowboat
addressees	adddresseees,addressees
hallowell	hallowwell,hallowell
showings	showwings,showings
saad	saaad,saad
storybook	storyboook,storybook
preeminently	preeeminently,preeminently
steeled	steeeled,steeled
troubleshoot	troubleshooot,troubleshoot
throwback	throwwback,throwback
ees	eees,ees
monsoons	monsooons,monsoons
cowling	cowwling,cowling
ook	oook,ook
smoot	smooot,smoot
cheerless	cheeerless,cheerless
homegrown	homegrowwn,homegrown
mushroomed	mushrooomed,mushroomed
brownlee	browwnleee,brownlee
meltdown	meltdowwn,meltdown
ozawa	ozawwa,ozawa
kooning	koooning,kooning
cartoonists	cartooonists,cartoonists
burrowed	burrowwed,burrowed
veneers	veneeers,veneers
disallowance	disallowwance,disallowance
footlights	foootlights,footlights
heartwood	heartwoood,heartwood
deeming	deeeming,deeming
oop	ooop,oop
weddell	wedddell,weddell
brushwood	brushwoood,brushwood
bloodletting	blooodletting,bloodletting
buffoon	buffooon,buffoon
innkeepers	innkeeepers,innkeepers
rowlands	rowwlands,rowlands
ballooning	balloooning,ballooning
saarc	saaarc,saarc
highbrow	highbroww,highbrow
oeec	oeeec,oeec
oooo	oooooo,oooo
streamflow	streamfloww,streamflow
cuddled	cudddled,cuddled
sorrowfully	sorrowwfully,sorrowfully
housekeepers	housekeeepers,housekeepers
thurlow	thurloww,thurlow
cuddle	cudddle,cuddle
shoo	shooo,shoo
caraway	carawway,caraway
noor	nooor,noor
middleaged	midddleaged,middleaged
gow	goww,gow
showa	showwa,showa
lowther	lowwther,lowther
staats	staaats,staats
downlink	dowwnlink,downlink
threequarters	threeequarters,threequarters
cutaway	cutawway,cutaway
eez	eeez,eez
lycee	lyceee,lycee
booke	boooke,booke
glowered	glowwered,glowered
weevils	weeevils,weevils
tcdd	tcddd,tcdd
shudders	shuddders,shudders
delawares	delawwares,delawares
middlemarch	midddlemarch,middlemarch
cheerleaders	cheeerleaders,cheerleaders
detainee	detaineee,detainee
rowers	rowwers,rowers
vajpayee	vajpayeee,vajpayee
schoolmen	schooolmen,schoolmen
leed	leeed,leed
jeddah	jedddah,jeddah
cowpea	cowwpea,cowpea
reek	reeek,reek
feebleness	feeebleness,feebleness
awami	awwami,awami
promisee	promiseee,promisee
awakes	awwakes,awakes
schoolyard	schooolyard,schoolyard
midafternoon	midafternooon,midafternoon
unneeded	unneeeded,unneeded
drowns	drowwns,drowns
billow	billoww,billow
dowels	dowwels,dowels
afterglow	aftergloww,afterglow
dowries	dowwries,dowries
redeems	redeeems,redeems
dda	ddda,dda
aar	aaar,aar
mowers	mowwers,mowers
peevish	peeevish,peevish
grownups	growwnups,grownups
mongoose	mongooose,mongoose
sowohl	sowwohl,sowohl
roosting	rooosting,roosting
woodside	wooodside,woodside
toothpicks	tooothpicks,toothpicks
downgrading	dowwngrading,downgrading
seedbed	seeedbed,seedbed
hooting	hoooting,hooting
deeps	deeeps,deeps
speedometer	speeedometer,speedometer
safflower	safflowwer,safflower
newsreels	newsreeels,newsreels
pulpwood	pulpwoood,pulpwood
laddie	ladddie,laddie
trapdoor	trapdooor,trapdoor
seesaw	seeesaww,seesaw
yaakov	yaaakov,yaakov
fawning	fawwning,fawning
dartmoor	dartmooor,dartmoor
deportees	deporteees,deportees
preceeding	preceeeding,preceeding
snowshoes	snowwshoes,snowshoes
legatee	legateee,legatee
coons	cooons,coons
chodorow	chodoroww,chodorow
edda	eddda,edda
fiddled	fidddled,fiddled
hideaway	hideawway,hideaway
smallwood	smallwoood,smallwood
zeeland	zeeeland,zeeland
gaddis	gadddis,gaddis
waterproofing	waterprooofing,waterproofing
spools	spoools,spools
lowermost	lowwermost,lowermost
mowrer	mowwrer,mowrer
mujahideen	mujahideeen,mujahideen
overshadowing	overshadowwing,overshadowing
teenaged	teeenaged,teenaged
brawling	brawwling,brawling
hollowness	hollowwness,hollowness
feeney	feeeney,feeney
thudding	thuddding,thudding
perigee	perigeee,perigee
sainthood	sainthoood,sainthood
tepee	tepeee,tepee
narrowband	narrowwband,narrowband
giveaway	giveawway,giveaway
stateroom	staterooom,stateroom
bawled	bawwled,bawled
leering	leeering,leering
meeks	meeeks,meeks
coffeehouse	coffeeehouse,coffeehouse
coffees	coffeees,coffees
brawny	brawwny,brawny
hoosier	hooosier,hoosier
saarinen	saaarinen,saarinen
oddest	odddest,oddest
saab	saaab,saab
taa	taaa,taa
choctaws	choctawws,choctaws
johnstown	johnstowwn,johnstown
jawed	jawwed,jawed
roomed	rooomed,roomed
nootka	noootka,nootka
bookbinding	boookbinding,bookbinding
sorrowing	sorrowwing,sorrowing
growls	growwls,growls
bloodiest	blooodiest,bloodiest
reeder	reeeder,reeder
childhoods	childhooods,childhoods
cloward	clowward,cloward
awakenings	awwakenings,awakenings
mcghee	mcgheee,mcghee
keele	keeele,keele
mckeown	mckeowwn,mckeown
megiddo	megidddo,megiddo
scree	screee,scree
sneers	sneeers,sneers
howitt	howwitt,howitt
avow	avoww,avow
hagerstown	hagerstowwn,hagerstown
cooped	coooped,cooped
goodbyes	gooodbyes,goodbyes
sloops	slooops,sloops
tooled	toooled,tooled
cowie	cowwie,cowie
straddles	stradddles,straddles
flowmeter	flowwmeter,flowmeter
sapwood	sapwoood,sapwood
seethed	seeethed,seethed
elysees	elyseees,elysees
greenough	greeenough,greenough
aap	aaap,aap
privateering	privateeering,privateering
townes	towwnes,townes
kapoor	kapooor,kapoor
cheeky	cheeeky,cheeky
downgrade	dowwngrade,downgrade
lndeed	lndeeed,lndeed
freezers	freeezers,freezers
coulee	couleee,coulee
santee	santeee,santee
aalto	aaalto,aalto
bloor	blooor,bloor
hightower	hightowwer,hightower
teetering	teeetering,teetering
yoon	yooon,yoon
kleenex	kleeenex,kleenex
hardee	hardeee,hardee
bowring	bowwring,bowring
jeers	jeeers,jeers
chowdhury	chowwdhury,chowdhury
staaten	staaaten,staaten
squaws	squawws,squaws
cuddling	cudddling,cuddling
feedbacks	feeedbacks,feedbacks
footstep	foootstep,footstep
cheesecloth	cheeesecloth,cheesecloth
hoodlums	hooodlums,hoodlums
sharpshooters	sharpshoooters,sharpshooters
craddock	cradddock,craddock
liddy	lidddy,liddy
leibowitz	leibowwitz,leibowitz
rootstock	roootstock,rootstock
meetinghouse	meeetinghouse,meetinghouse
awnings	awwnings,awnings
reeked	reeeked,reeked
headdresses	headddresses,headdresses
crawler	crawwler,crawler
vroom	vrooom,vroom
chaffee	chaffeee,chaffee
powering	powwering,powering
dupree	dupreee,dupree
freest	freeest,freest
roosters	rooosters,roosters
greenbacks	greeenbacks,greenbacks
stowage	stowwage,stowage
supervisee	superviseee,supervisee
huddersfield	hudddersfield,huddersfield
lawman	lawwman,lawman
scrawl	scrawwl,scrawl
fowles	fowwles,fowles
clowning	clowwning,clowning
allee	alleee,allee
reevaluated	reeevaluated,reevaluated
meyerbeer	meyerbeeer,meyerbeer
elbowed	elbowwed,elbowed
blowout	blowwout,blowout
middlebury	midddlebury,middlebury
cheerily	cheeerily,cheerily
bloomberg	blooomberg,bloomberg
menominee	menomineee,menominee
howsoever	howwsoever,howsoever
plowden	plowwden,plowden
ecowas	ecowwas,ecowas
overblown	overblowwn,overblown
steelmaking	steeelmaking,steelmaking
hornblower	hornblowwer,hornblower
seele	seeele,seele
doon	dooon,doon
brawls	brawwls,brawls
milkweed	milkweeed,milkweed
reeducation	reeeducation,reeducation
antifreeze	antifreeeze,antifreeze
brentwood	brentwoood,brentwood
toomer	tooomer,toomer
fallows	fallowws,fallows
mcafee	mcafeee,mcafee
snowmobile	snowwmobile,snowmobile
sooth	soooth,sooth
crowbar	crowwbar,crowbar
watchtower	watchtowwer,watchtower
shredding	shreddding,shredding
giddiness	gidddiness,giddiness
lunchroom	lunchrooom,lunchroom
eeo	eeeo,eeo
swidden	swiddden,swidden
outgrowths	outgrowwths,outgrowths
bestowal	bestowwal,bestowal
mallow	malloww,mallow
ddd	dddd,ddd
cyclooxygenase	cycloooxygenase,cyclooxygenase
jubilees	jubileees,jubilees
kawai	kawwai,kawai
hooligans	hoooligans,hooligans
twentythree	twentythreee,twentythree
siddons	sidddons,siddons
linlithgow	linlithgoww,linlithgow
knowhow	knowwhoww,knowhow
leeuwen	leeeuwwen,leeuwen
hedgerow	hedgeroww,hedgerow
grandees	grandeees,grandees
hayakawa	hayakawwa,hayakawa
pantaloons	pantalooons,pantaloons
beerbohm	beeerbohm,beerbohm
showmanship	showwmanship,showmanship
haa	haaa,haa
booklist	boooklist,booklist
macdowell	macdowwell,macdowell
honeybees	honeybeees,honeybees
speedway	speeedway,speedway
screenplays	screeenplays,screenplays
isaacson	isaaacson,isaacson
graaff	graaaff,graaff
prowled	prowwled,prowled
ddl	dddl,ddl
honeybee	honeybeee,honeybee
typhoons	typhooons,typhoons
overdrawn	overdrawwn,overdrawn
peacekeepers	peacekeeepers,peacekeepers
frisbee	frisbeee,frisbee
addressable	adddressable,addressable
showcases	showwcases,showcases
annee	anneee,annee
reawakening	reawwakening,reawakening
pawing	pawwing,pawing
gooseberry	goooseberry,gooseberry
stooges	stoooges,stooges
overweening	overweeening,overweening
moores	mooores,moores
weems	weeems,weems
mown	mowwn,mown
moodie	mooodie,moodie
allentown	allentowwn,allentown
sweetwater	sweeetwater,sweetwater
stoddart	stodddart,stoddart
coote	cooote,coote
dowden	dowwden,dowden
ridder	riddder,ridder
shaanxi	shaaanxi,shaanxi
uwe	uwwe,uwe
veen	veeen,veen
cottonwoods	cottonwooods,cottonwoods
wootton	woootton,wootton
kurosawa	kurosawwa,kurosawa
staatliche	staaatliche,staatliche
qaddafi	qadddafi,qaddafi
footwork	foootwork,footwork
gleeful	gleeeful,gleeful
lakewood	lakewoood,lakewood
coetzee	coetzeee,coetzee
saavedra	saaavedra,saavedra
highspeed	highspeeed,highspeed
deering	deeering,deering
moorhead	mooorhead,moorhead
brawn	brawwn,brawn
dowson	dowwson,dowson
trawling	trawwling,trawling
kool	koool,kool
absentees	absenteees,absentees
mushrooming	mushroooming,mushrooming
freestyle	freeestyle,freestyle
boor	booor,boor
howdy	howwdy,howdy
rapeseed	rapeseeed,rapeseed
griddle	gridddle,griddle
swaddling	swadddling,swaddling
henshaw	henshaww,henshaw
eee	eeee,eee
befuddled	befudddled,befuddled
wedderburn	weddderburn,wedderburn
deen	deeen,deen
nawaz	nawwaz,nawaz
iddm	idddm,iddm
cowered	cowwered,cowered
fellowmen	fellowwmen,fellowmen
coomaraswamy	cooomaraswamy,coomaraswamy
kanawha	kanawwha,kanawha
footbridge	foootbridge,footbridge
bylaw	bylaww,bylaw
barroom	barrooom,barroom
greenbelt	greeenbelt,greenbelt
ringwood	ringwoood,ringwood
ooooo	ooooooo,ooooo
dowdy	dowwdy,dowdy
sneezed	sneeezed,sneezed
noo	nooo,noo
spooked	spoooked,spooked
beersheba	beeersheba,beersheba
looters	loooters,looters
looseleaf	loooseleaf,looseleaf
flowrate	flowwrate,flowrate
floodgates	flooodgates,floodgates
sweetmeats	sweeetmeats,sweetmeats
buccaneer	buccaneeer,buccaneer
trooped	troooped,trooped
middens	midddens,middens
downer	dowwner,downer
clawson	clawwson,clawson
kook	koook,kook
homeownership	homeowwnership,homeownership
huddleston	hudddleston,huddleston
goon	gooon,goon
aat	aaat,aat
reentrant	reeentrant,reentrant
reenact	reeenact,reenact
marshmallow	marshmalloww,marshmallow
jeez	jeeez,jeez
megawatts	megawwatts,megawatts
aaas	aaaas,aaas
dowell	dowwell,dowell
peet	peeet,peet
kaddish	kadddish,kaddish
whoops	whooops,whoops
zoologists	zooologists,zoologists
granddaughters	grandddaughters,granddaughters
laidlaw	laidlaww,laidlaw
queenie	queeenie,queenie
leeuw	leeeuww,leeuw
homeroom	homerooom,homeroom
coors	cooors,coors
booting	boooting,booting
snowshoe	snowwshoe,snowshoe
andree	andreee,andree
sideshow	sideshoww,sideshow
hipaa	hipaaa,hipaa
mahmood	mahmoood,mahmood
seaworthy	seawworthy,seaworthy
wheeze	wheeeze,wheeze
billowed	billowwed,billowed
horwood	horwoood,horwood
maddison	madddison,maddison
leeuwenhoek	leeeuwwenhoek,leeuwenhoek
catawba	catawwba,catawba
awestruck	awwestruck,awestruck
loosens	looosens,loosens
dinwiddie	dinwidddie,dinwiddie
clowes	clowwes,clowes
heirlooms	heirloooms,heirlooms
redrawing	redrawwing,redrawing
kees	keees,kees
greenaway	greeenawway,greenaway
trow	troww,trow
glowering	glowwering,glowering
renshaw	renshaww,renshaw
nakagawa	nakagawwa,nakagawa
logbook	logboook,logbook
seemly	seeemly,seemly
boole	booole,boole
geek	geeek,geek
kozlowski	kozlowwski,kozlowski
yow	yoww,yow
raab	raaab,raab
janowitz	janowwitz,janowitz
reemergence	reeemergence,reemergence
cooed	coooed,cooed
foothill	fooothill,foothill
lookouts	loookouts,lookouts
divorcee	divorceee,divorcee
counselee	counseleee,counselee
unawareness	unawwareness,unawareness
sweezy	sweeezy,sweezy
adders	addders,adders
boorstin	booorstin,boorstin
aal	aaal,aal
coos	cooos,coos
snoop	snooop,snoop
caddo	cadddo,caddo
haase	haaase,haase
freewheeling	freeewheeeling,freewheeling
foreseeability	foreseeeability,foreseeability
weel	weeel,weel
stylesheet	stylesheeet,stylesheet
facedown	facedowwn,facedown
schoolcraft	schooolcraft,schoolcraft
cathleen	cathleeen,cathleen
sherbrooke	sherbroooke,sherbrooke
awolowo	awwolowwo,awolowo
peele	peeele,peele
keeton	keeeton,keeton
keeling	keeeling,keeling
needling	neeedling,needling
intraabdominal	intraaabdominal,intraabdominal
crookes	croookes,crookes
keesing	keeesing,keesing
oilseed	oilseeed,oilseed
shampoos	shampooos,shampoos
mowat	mowwat,mowat
poorhouse	pooorhouse,poorhouse
braintree	braintreee,braintree
snowdon	snowwdon,snowdon
downturns	dowwnturns,downturns
throwers	throwwers,throwers
wildflower	wildflowwer,wildflower
needlepoint	neeedlepoint,needlepoint
caw	caww,caw
schooldays	schoooldays,schooldays
seeman	seeeman,seeman
zoot	zooot,zoot
crawfish	crawwfish,crawfish
yawns	yawwns,yawns
freeland	freeeland,freeland
granddad	grandddad,granddad
niddm	nidddm,niddm
keeley	keeeley,keeley
nieuwe	nieuwwe,nieuwe
hadden	haddden,hadden
lowed	lowwed,lowed
marshmallows	marshmallowws,marshmallows
arrowsmith	arrowwsmith,arrowsmith
flaxseed	flaxseeed,flaxseed
escapees	escapeees,escapees
jowar	jowwar,jowar
seedless	seeedless,seedless
leery	leeery,leery
barstow	barstoww,barstow
peddle	pedddle,peddle
beefy	beeefy,beefy
creech	creeech,creech
throwaway	throwwawway,throwaway
whirlpools	whirlpoools,whirlpools
fiddlers	fidddlers,fiddlers
courtrooms	courtroooms,courtrooms
windowed	windowwed,windowed
dawley	dawwley,dawley
ragweed	ragweeed,ragweed
howards	howwards,howards
scooters	scoooters,scooters
showrooms	showwroooms,showrooms
bloomingdale	blooomingdale,bloomingdale
soothes	sooothes,soothes
onslow	onsloww,onslow
geelong	geeelong,geelong
spoor	spooor,spoor
sleepwalking	sleeepwalking,sleepwalking
preening	preeening,preening
preschooler	preschoooler,preschooler
windblown	windblowwn,windblown
queenstown	queeenstowwn,queenstown
streetlights	streeetlights,streetlights
sewanee	sewaneee,sewanee
browsed	browwsed,browsed
profiteers	profiteeers,profiteers
overawed	overawwed,overawed
downbeat	dowwnbeat,downbeat
teeter	teeeter,teeter
lefkowitz	lefkowwitz,lefkowitz
lidded	liddded,lidded
betook	betoook,betook
forsooth	forsoooth,forsooth
whoosh	whooosh,whoosh
paddocks	padddocks,paddocks
rosenbloom	rosenblooom,rosenbloom
steeples	steeeples,steeples
baas	baaas,baas
powwow	powwwoww,powwow
spoof	spooof,spoof
huddling	hudddling,huddling
wheelhouse	wheeelhouse,wheelhouse
greenbaum	greeenbaum,greenbaum
oocysts	ooocysts,oocysts
yaws	yawws,yaws
siddha	sidddha,siddha
fawns	fawwns,fawns
deeded	deeeded,deeded
coot	cooot,coot
dees	deees,dees
foodborne	fooodborne,foodborne
morgantown	morgantowwn,morgantown
townsville	towwnsville,townsville
spottiswoode	spottiswooode,spottiswoode
floodlights	flooodlights,floodlights
schoolgirls	schooolgirls,schoolgirls
storekeepers	storekeeepers,storekeepers
manatee	manateee,manatee
saddlebags	sadddlebags,saddlebags
aws	awws,aws
ingrowth	ingrowwth,ingrowth
interbreeding	interbreeeding,interbreeding
toole	tooole,toole
kanagawa	kanagawwa,kanagawa
feedwater	feeedwater,feedwater
woodhull	wooodhull,woodhull
supercooled	supercoooled,supercooled
annees	anneees,annees
peephole	peeephole,peephole
awaking	awwaking,awaking
cooperstown	coooperstowwn,cooperstown
reawakened	reawwakened,reawakened
beeches	beeeches,beeches
noreen	noreeen,noreen
karoo	karooo,karoo
threeyear	threeeyear,threeyear
codebook	codeboook,codebook
goatee	goateee,goatee
gazetteers	gazetteeers,gazetteers
boxwood	boxwoood,boxwood
careening	careeening,careening
stowell	stowwell,stowell
woodwinds	wooodwinds,woodwinds
lowie	lowwie,lowie
oogenesis	ooogenesis,oogenesis
townsman	towwnsman,townsman
freelancers	freeelancers,freelancers
boorish	booorish,boorish
hopwood	hopwoood,hopwood
igloo	iglooo,igloo
muddling	mudddling,muddling
beekman	beeekman,beekman
peeters	peeeters,peeters
hapgood	hapgoood,hapgood
boos	booos,boos
potawatomi	potawwatomi,potawatomi
greenback	greeenback,greenback
tdd	tddd,tdd
yoshikawa	yoshikawwa,yoshikawa
cheesy	cheeesy,cheesy
bowyer	bowwyer,bowyer
maar	maaar,maar
backdoor	backdooor,backdoor
overshadows	overshadowws,overshadows
greenness	greeenness,greenness
touchdowns	touchdowwns,touchdowns
addi	adddi,addi
baleen	baleeen,baleen
pawnbroker	pawwnbroker,pawnbroker
fiddles	fidddles,fiddles
maarten	maaarten,maarten
consultee	consulteee,consultee
gooding	goooding,gooding
breastfeed	breastfeeed,breastfeed
queers	queeers,queers
freeborn	freeeborn,freeborn
downloadable	dowwnloadable,downloadable
charlottetown	charlottetowwn,charlottetown
wladyslaw	wladyslaww,wladyslaw
snowmelt	snowwmelt,snowmelt
taw	taww,taw
rawdon	rawwdon,rawdon
fawkes	fawwkes,fawkes
woodard	wooodard,woodard
gaa	gaaa,gaa
idees	ideees,idees
unseeing	unseeeing,unseeing
airpower	airpowwer,airpower
jawbone	jawwbone,jawbone
underflow	underfloww,underflow
hookups	hoookups,hookups
goalkeeper	goalkeeeper,goalkeeper
ebook	eboook,ebook
tycoons	tycooons,tycoons
bioengineering	bioengineeering,bioengineering
bronislaw	bronislaww,bronislaw
caddie	cadddie,caddie
deerskin	deeerskin,deerskin
volunteerism	volunteeerism,volunteerism
footfalls	foootfalls,footfalls
seabrook	seabroook,seabrook
hawkeye	hawwkeye,hawkeye
letdown	letdowwn,letdown
storerooms	storeroooms,storerooms
muddied	mudddied,muddied
kneed	kneeed,kneed
feelin	feeelin,feelin
pureed	pureeed,pureed
cowries	cowwries,cowries
seely	seeely,seely
bulletproof	bulletprooof,bulletproof
corvee	corveee,corvee
bulow	buloww,bulow
taal	taaal,taal
townley	towwnley,townley
gowon	gowwon,gowon
veers	veeers,veers
auctioneers	auctioneeers,auctioneers
speedier	speeedier,speedier
broomstick	brooomstick,broomstick
bootleg	boootleg,bootleg
soothsayer	sooothsayer,soothsayer
looker	loooker,looker
cloakroom	cloakrooom,cloakroom
liddle	lidddle,liddle
stroop	strooop,stroop
grahamstown	grahamstowwn,grahamstown
beene	beeene,beene
moonless	mooonless,moonless
reemerged	reeemerged,reemerged
sweetening	sweeetening,sweetening
gabaa	gabaaa,gabaa
shawnees	shawwneees,shawnees
beekeeping	beeekeeeping,beekeeping
capetown	capetowwn,capetown
oozes	ooozes,oozes
toots	tooots,toots
ichikawa	ichikawwa,ichikawa
goons	gooons,goons
downie	dowwnie,downie
sowell	sowwell,sowell
hoots	hooots,hoots
feedstocks	feeedstocks,feedstocks
trelawny	trelawwny,trelawny
seest	seeest,seest
bloomers	blooomers,bloomers
slaveowners	slaveowwners,slaveowners
hindoos	hindooos,hindoos
schoolbooks	schooolboooks,schoolbooks
coffeepot	coffeeepot,coffeepot
bloodbath	blooodbath,bloodbath
algaas	algaaas,algaas
bedfellows	bedfellowws,bedfellows
groote	grooote,groote
walloon	wallooon,walloon
thurow	thuroww,thurow
rowlandson	rowwlandson,rowlandson
allaah	allaaah,allaah
cooperators	coooperators,cooperators
hookup	hoookup,hookup
europeenne	europeeenne,europeenne
pawed	pawwed,pawed
parolees	paroleees,parolees
littlewood	littlewoood,littlewood
rootedness	roootedness,rootedness
peddled	pedddled,peddled
creeley	creeeley,creeley
rootstocks	roootstocks,rootstocks
piscataway	piscatawway,piscataway
dashwood	dashwoood,dashwood
beeper	beeeper,beeper
awt	awwt,awt
kiddie	kidddie,kiddie
greenhill	greeenhill,greenhill
wooldridge	woooldridge,wooldridge
spermatozoon	spermatozooon,spermatozoon
wheelers	wheeelers,wheelers
oophorectomy	ooophorectomy,oophorectomy
wools	woools,wools
woodville	wooodville,woodville
pawned	pawwned,pawned
assignees	assigneees,assignees
cawnpore	cawwnpore,cawnpore
pamphleteer	pamphleteeer,pamphleteer
keeney	keeeney,keeney
attwood	attwoood,attwood
leeson	leeeson,leeson
festoons	festooons,festoons
squawk	squawwk,squawk
workflows	workflowws,workflows
chafee	chafeee,chafee
dataflow	datafloww,dataflow
cowrie	cowwrie,cowrie
amputee	amputeee,amputee
beelzebub	beeelzebub,beelzebub
bestknown	bestknowwn,bestknown
woodlawn	wooodlawwn,woodlawn
waddled	wadddled,waddled
joo	jooo,joo
draftees	drafteees,draftees
woodsman	wooodsman,woodsman
cuddly	cudddly,cuddly
cranbrook	cranbroook,cranbrook
crowne	crowwne,crowne
windowing	windowwing,windowing
murfreesboro	murfreeesboro,murfreesboro
oot	ooot,oot
cookson	coookson,cookson
ranee	raneee,ranee
meed	meeed,meed
woodcutter	wooodcutter,woodcutter
redd	reddd,redd
grameen	grameeen,grameen
foodservice	fooodservice,foodservice
stokowski	stokowwski,stokowski
cheerleading	cheeerleading,cheerleading
mawson	mawwson,mawson
drool	droool,drool
doorkeeper	dooorkeeeper,doorkeeper
broadsheet	broadsheeet,broadsheet
looney	loooney,looney
tarawa	tarawwa,tarawa
wheelbase	wheeelbase,wheelbase
williamstown	williamstowwn,williamstown
woodhead	wooodhead,woodhead
spoonfuls	spooonfuls,spoonfuls
bowsprit	bowwsprit,bowsprit
wildebeest	wildebeeest,wildebeest
kiowas	kiowwas,kiowas
crooned	croooned,crooned
pownall	powwnall,pownall
goodfellow	gooodfelloww,goodfellow
wardroom	wardrooom,wardroom
flawlessly	flawwlessly,flawlessly
softwoods	softwooods,softwoods
granddaddy	grandddadddy,granddaddy
seawall	seawwall,seawall
pensees	penseees,pensees
loons	looons,loons
soiree	soireee,soiree
hows	howws,hows
keely	keeely,keely
bassoons	bassooons,bassoons
keeled	keeeled,keeled
vaal	vaaal,vaal
acknowledg	acknowwledg,acknowledg
toombs	tooombs,toombs
undertow	undertoww,undertow
woodblock	wooodblock,woodblock
crooning	croooning,crooning
coops	cooops,coops
obligee	obligeee,obligee
koopmans	kooopmans,koopmans
wadding	waddding,wadding
loony	looony,loony
bootstrapping	boootstrapping,bootstrapping
lawlor	lawwlor,lawlor
hooghly	hoooghly,hooghly
jowl	jowwl,jowl
jeer	jeeer,jeer
cookers	coookers,cookers
sowerby	sowwerby,sowerby
cower	cowwer,cower
refereed	refereeed,refereed
parakeet	parakeeet,parakeet
noontime	nooontime,noontime
dfee	dfeee,dfee
steelworks	steeelworks,steelworks
buddhistic	budddhistic,buddhistic
ideen	ideeen,ideen
ujamaa	ujamaaa,ujamaa
teeny	teeeny,teeny
squawking	squawwking,squawking
rootlets	roootlets,rootlets
snook	snoook,snook
toon	tooon,toon
caboose	cabooose,caboose
raad	raaad,raad
hookers	hoookers,hookers
siddhanta	sidddhanta,siddhanta
addisonwesley	adddisonwesley,addisonwesley
cowherd	cowwherd,cowherd
howrah	howwrah,howrah
gwynedd	gwyneddd,gwynedd
lowliest	lowwliest,lowliest
reemployment	reeemployment,reemployment
keels	keeels,keels
neer	neeer,neer
meena	meeena,meena
leela	leeela,leela
feeler	feeeler,feeler
maynooth	maynoooth,maynooth
thudded	thuddded,thudded
designee	designeee,designee
hooray	hoooray,hooray
broward	browward,broward
chooser	choooser,chooser
sightseers	sightseeers,sightseers
ingaas	ingaaas,ingaas
graaf	graaaf,graaf
irrawaddy	irrawwadddy,irrawaddy
stowing	stowwing,stowing
cesspool	cesspoool,cesspool
addy	adddy,addy
ameer	ameeer,ameer
tows	towws,tows
dalloway	dallowway,dalloway
noone	nooone,noone
riddance	ridddance,riddance
toothbrushes	tooothbrushes,toothbrushes
voorhees	vooorheees,voorhees
spee	speee,spee
codd	coddd,codd
spawns	spawwns,spawns
predawn	predawwn,predawn
roomful	rooomful,roomful
greenock	greeenock,greenock
careened	careeened,careened
surtees	surteees,surtees
bigfoot	bigfooot,bigfoot
gooey	goooey,gooey
booed	boooed,booed
keepsake	keeepsake,keepsake
moonlighting	mooonlighting,moonlighting
incoordination	incooordination,incoordination
bowditch	bowwditch,bowditch
jaworski	jawworski,jaworski
moorman	mooorman,moorman
megawatt	megawwatt,megawatt
boerhaave	boerhaaave,boerhaave
harpoons	harpooons,harpoons
koop	kooop,koop
lampoon	lampooon,lampoon
adduces	addduces,adduces
lowrie	lowwrie,lowrie
gowan	gowwan,gowan
lowpass	lowwpass,lowpass
gamekeeper	gamekeeeper,gamekeeper
proofreader	prooofreader,proofreader
pontoons	pontooons,pontoons
freemason	freeemason,freemason
hazelwood	hazelwoood,hazelwood
goodell	gooodell,goodell
kawamura	kawwamura,kawamura
brokaw	brokaww,brokaw
pawnees	pawwneees,pawnees
longwood	longwoood,longwood
hooliganism	hoooliganism,hooliganism
shree	shreee,shree
preestablished	preeestablished,preestablished
uddi	udddi,uddi
feebleminded	feeebleminded,feebleminded
pardee	pardeee,pardee
stooge	stoooge,stooge
poon	pooon,poon
schooler	schoooler,schooler
midnineteenth	midnineteeenth,midnineteenth
teemed	teeemed,teemed
jee	jeee,jee
steedman	steeedman,steedman
freewill	freeewill,freewill
okinawan	okinawwan,okinawan
chattahoochee	chattahooocheee,chattahoochee
lackawanna	lackawwanna,lackawanna
saeed	saeeed,saeed
freeboard	freeeboard,freeboard
rookery	roookery,rookery
ddp	dddp,ddp
followings	followwings,followings
schoolers	schooolers,schoolers
cooperativity	coooperativity,cooperativity
glenwood	glenwoood,glenwood
sixteenthcentury	sixteeenthcentury,sixteenthcentury
wallowed	wallowwed,wallowed
bookkeepers	boookkeeepers,bookkeepers
spoofing	spooofing,spoofing
downswing	dowwnswing,downswing
shakedown	shakedowwn,shakedown
kawakami	kawwakami,kawakami
wildwood	wildwoood,wildwood
unhooked	unhoooked,unhooked
gooseberries	goooseberries,gooseberries
bloodline	blooodline,bloodline
baath	baaath,baath
wadded	waddded,wadded
aau	aaau,aau
lowes	lowwes,lowes
cockatoo	cockatooo,cockatoo
rabinow	rabinoww,rabinow
widdowson	widddowwson,widdowson
oxbow	oxboww,oxbow
woodbine	wooodbine,woodbine
jowls	jowwls,jowls
aam	aaam,aam
crashaw	crashaww,crashaw
toffee	toffeee,toffee
puppeteer	puppeteeer,puppeteer
zoospores	zooospores,zoospores
downplaying	dowwnplaying,downplaying
windowpane	windowwpane,windowpane
subtrees	subtreees,subtrees
oort	ooort,oort
earnshaw	earnshaww,earnshaw
backflow	backfloww,backflow
meech	meeech,meech
reeks	reeeks,reeks
letterbook	letterboook,letterbook
rockwood	rockwoood,rockwood
snowballs	snowwballs,snowballs
goodson	gooodson,goodson
toomey	tooomey,toomey
redden	reddden,redden
roosts	rooosts,roosts
teetered	teeetered,teetered
outlawry	outlawwry,outlawry
gleeson	gleeeson,gleeson
bowstring	bowwstring,bowstring
investee	investeee,investee
perrow	perroww,perrow
truckee	truckeee,truckee
jawahar	jawwahar,jawahar
footloose	foootlooose,footloose
mccook	mccoook,mccook
schoolmate	schooolmate,schoolmate
moorehead	mooorehead,moorehead
beeson	beeeson,beeson
threesome	threeesome,threesome
bowlers	bowwlers,bowlers
doorsteps	dooorsteps,doorsteps
kitagawa	kitagawwa,kitagawa
easterbrook	easterbroook,easterbrook
loopback	looopback,loopback
wheezed	wheeezed,wheezed
supercooling	supercoooling,supercooling
tooley	toooley,tooley
townsite	towwnsite,townsite
kanazawa	kanazawwa,kanazawa
munksgaard	munksgaaard,munksgaard
browed	browwed,browed
soothsayers	sooothsayers,soothsayers
arrowroot	arrowwrooot,arrowroot
maddalena	madddalena,maddalena
unredeemed	unredeeemed,unredeemed
palawan	palawwan,palawan
deepak	deeepak,deepak
owi	owwi,owi
peeler	peeeler,peeler
typee	typeee,typee
grownup	growwnup,grownup
gamow	gamoww,gamow
howlett	howwlett,howlett
benbow	benboww,benbow
jamaat	jamaaat,jamaat
knowers	knowwers,knowers
sheeted	sheeeted,sheeted
donnees	donneees,donnees
museen	museeen,museen
bridgetown	bridgetowwn,bridgetown
bowser	bowwser,bowser
disallowing	disallowwing,disallowing
shirtsleeves	shirtsleeeves,shirtsleeves
tedder	teddder,tedder
eet	eeet,eet
feedlot	feeedlot,feedlot
leet	leeet,leet
hollowing	hollowwing,hollowing
jeeves	jeeeves,jeeves
goodhart	gooodhart,goodhart
coffeehouses	coffeeehouses,coffeehouses
saatchi	saaatchi,saatchi
vdd	vddd,vdd
lowi	lowwi,lowi
fedayeen	fedayeeen,fedayeen
jarrow	jarroww,jarrow
abramowitz	abramowwitz,abramowitz
furukawa	furukawwa,furukawa
wildfowl	wildfowwl,wildfowl
swooning	swoooning,swooning
bloodhound	blooodhound,bloodhound
amputees	amputeees,amputees
laocoon	laocooon,laocoon
buffoonery	buffooonery,buffoonery
cheekbone	cheeekbone,cheekbone
meehl	meeehl,meehl
misdeed	misdeeed,misdeed
keening	keeening,keening
howler	howwler,howler
gladdened	gladddened,gladdened
foodgrain	fooodgrain,foodgrain
geen	geeen,geen
supervisees	superviseees,supervisees
spleens	spleeens,spleens
woodchuck	wooodchuck,woodchuck
arawak	arawwak,arawak
racketeers	racketeeers,racketeers
ower	owwer,ower
shawcross	shawwcross,shawcross
woolens	wooolens,woolens
hawkesbury	hawwkesbury,hawkesbury
zooms	zoooms,zooms
banshee	bansheee,banshee
scoot	scooot,scoot
townhouses	towwnhouses,townhouses
kickapoo	kickapooo,kickapoo
castaways	castawways,castaways
screenwriters	screeenwriters,screenwriters
bukowski	bukowwski,bukowski
overshooting	overshoooting,overshooting
aaup	aaaup,aaup
lawmen	lawwmen,lawmen
babyhood	babyhoood,babyhood
committeeman	committeeeman,committeeman
torchbooks	torchboooks,torchbooks
headroom	headrooom,headroom
bardeen	bardeeen,bardeen
baader	baaader,baader
scow	scoww,scow
showcased	showwcased,showcased
highschool	highschoool,highschool
coombe	cooombe,coombe
wolfowitz	wolfowwitz,wolfowitz
nonfood	nonfoood,nonfood
queensberry	queeensberry,queensberry
spaatz	spaaatz,spaatz
rooke	roooke,rooke
freestone	freeestone,freestone
floodwaters	flooodwaters,floodwaters
moonstone	mooonstone,moonstone
addled	adddled,addled
boobs	booobs,boobs
koopman	kooopman,koopman
deena	deeena,deena
unschooled	unschoooled,unschooled
distributee	distributeee,distributee
yukawa	yukawwa,yukawa
larrabee	larrabeee,larrabee
soirees	soireees,soirees
awls	awwls,awls
moodiness	mooodiness,moodiness
ballooned	balloooned,ballooned
noncooperation	noncoooperation,noncooperation
shooed	shoooed,shooed
bloodstains	blooodstains,bloodstains
shutdowns	shutdowwns,shutdowns
wintergreen	wintergreeen,wintergreen
goof	gooof,goof
hardihood	hardihoood,hardihood
tarrytown	tarrytowwn,tarrytown
beekeepers	beeekeeepers,beekeepers
garrow	garroww,garrow
meow	meoww,meow
paar	paaar,paar
youngblood	youngbloood,youngblood
tabooed	taboooed,tabooed
caddis	cadddis,caddis
christiaan	christiaaan,christiaan
knowl	knowwl,knowl
castaway	castawway,castaway
deerslayer	deeerslayer,deerslayer
oolitic	ooolitic,oolitic
beeps	beeeps,beeps
starfleet	starfleeet,starfleet
lawmaker	lawwmaker,lawmaker
beefsteak	beeefsteak,beefsteak
awol	awwol,awol
boons	booons,boons
feddans	fedddans,feddans
moodily	mooodily,moodily
saami	saaami,saami
saddler	sadddler,saddler
prowler	prowwler,prowler
aberdeenshire	aberdeeenshire,aberdeenshire
preece	preeece,preece
scowcroft	scowwcroft,scowcroft
disempowered	disempowwered,disempowered
noncooperative	noncoooperative,noncooperative
coomassie	cooomassie,coomassie
hosokawa	hosokawwa,hosokawa
elmwood	elmwoood,elmwood
footholds	foootholds,footholds
reebok	reeebok,reebok
bootlegging	boootlegging,bootlegging
macaw	macaww,macaw
naaman	naaaman,naaman
kenwood	kenwoood,kenwood
legatees	legateees,legatees
lawrie	lawwrie,lawrie
fanshawe	fanshawwe,fanshawe
koontz	kooontz,koontz
paddlers	padddlers,paddlers
parolee	paroleee,parolee
wooley	woooley,wooley
fleecy	fleeecy,fleecy
grooving	groooving,grooving
freeware	freeeware,freeware
bawl	bawwl,bawl
oom	ooom,oom
brooker	broooker,brooker
siddhi	sidddhi,siddhi
northbrook	northbroook,northbrook
soddy	sodddy,soddy
flamsteed	flamsteeed,flamsteed
goddammit	godddammit,goddammit
woodley	wooodley,woodley
leeper	leeeper,leeper
feelingly	feeelingly,feelingly
pawtucket	pawwtucket,pawtucket
daewoo	daewooo,daewoo
aai	aaai,aai
oakwood	oakwoood,oakwood
reexamining	reeexamining,reexamining
hangchow	hangchoww,hangchow
bowmen	bowwmen,bowmen
woolman	wooolman,woolman
medawar	medawwar,medawar
goodlooking	gooodloooking,goodlooking
rudders	ruddders,rudders
graal	graaal,graal
reddi	redddi,reddi
bloodhounds	blooodhounds,bloodhounds
schoolwide	schooolwide,schoolwide
goodnow	gooodnoww,goodnow
bootleggers	boootleggers,bootleggers
dooms	doooms,dooms
downstage	dowwnstage,downstage
crooke	croooke,crooke
shallowly	shallowwly,shallowly
shootout	shoootout,shootout
woodall	wooodall,woodall
towner	towwner,towner
chickadee	chickadeee,chickadee
coogan	cooogan,coogan
swaddled	swadddled,swaddled
eichengreen	eichengreeen,eichengreen
coopted	cooopted,coopted
rowse	rowwse,rowse
beeline	beeeline,beeline
hinshaw	hinshaww,hinshaw
muskogee	muskogeee,muskogee
kow	koww,kow
cooptation	coooptation,cooptation
goodspeed	gooodspeeed,goodspeed
vedder	veddder,vedder
jastrow	jastroww,jastrow
peeps	peeeps,peeps
swooned	swoooned,swooned
smokescreen	smokescreeen,smokescreen
budded	buddded,budded
lawbreakers	lawwbreakers,lawbreakers
woodburn	wooodburn,woodburn
adoptee	adopteee,adoptee
cuckoos	cuckooos,cuckoos
bloodlines	blooodlines,bloodlines
oor	ooor,oor
veena	veeena,veena
owain	owwain,owain
agreeableness	agreeeableness,agreeableness
hallows	hallowws,hallows
selfawareness	selfawwareness,selfawareness
spooned	spoooned,spooned
geeta	geeeta,geeta
showpiece	showwpiece,showpiece
pawnshop	pawwnshop,pawnshop
bumblebee	bumblebeee,bumblebee
preschools	preschoools,preschools
awg	awwg,awg
gatewood	gatewoood,gatewood
boothby	booothby,boothby
teem	teeem,teem
cookware	coookware,cookware
nowe	nowwe,nowe
breslow	bresloww,breslow
seeth	seeeth,seeth
goodlad	gooodlad,goodlad
basswood	basswoood,basswood
goodale	gooodale,goodale
keefer	keeefer,keefer
slaw	slaww,slaw
lwow	lwoww,lwow
waddling	wadddling,waddling
dropdown	dropdowwn,dropdown
whooped	whoooped,whooped
saleem	saleeem,saleem
coord	cooord,coord
daa	daaa,daa
wheelbarrows	wheeelbarrowws,wheelbarrows
seethe	seeethe,seethe
pdd	pddd,pdd
aaai	aaaai,aaai
awk	awwk,awk
katowice	katowwice,katowice
bisbee	bisbeee,bisbee
puddling	pudddling,puddling
veneered	veneeered,veneered
footplate	foootplate,footplate
snooze	snoooze,snooze
spaak	spaaak,spaak
paratrooper	paratroooper,paratrooper
woodpile	wooodpile,woodpile
woodshed	wooodshed,woodshed
stateowned	stateowwned,stateowned
drawstring	drawwstring,drawstring
sawyers	sawwyers,sawyers
heeft	heeeft,heeft
rowling	rowwling,rowling
hooch	hoooch,hooch
browner	browwner,browner
beery	beeery,beery
gatekeeping	gatekeeeping,gatekeeping
middles	midddles,middles
owings	owwings,owings
lowestoft	lowwestoft,lowestoft
carlow	carloww,carlow
brawley	brawwley,brawley
wadden	waddden,wadden
aaaa	aaaaaa,aaaa
embree	embreee,embree
seemeth	seeemeth,seemeth
downregulation	dowwnregulation,downregulation
meddlesome	medddlesome,meddlesome
twee	tweee,twee
reentering	reeentering,reentering
steelers	steeelers,steelers
eaa	eaaa,eaa
smoothest	smooothest,smoothest
decreeing	decreeeing,decreeing
tweeds	tweeeds,tweeds
wooten	woooten,wooten
ceecs	ceeecs,ceecs
eer	eeer,eer
smooths	smoooths,smooths
mowry	mowwry,mowry
goodnatured	gooodnatured,goodnatured
dowsing	dowwsing,dowsing
ironwood	ironwoood,ironwood
chapbook	chapboook,chapbook
bdd	bddd,bdd
kareem	kareeem,kareem
hawkish	hawwkish,hawkish
carrageenan	carrageeenan,carrageenan
rookies	roookies,rookies
tearoom	tearooom,tearoom
bhawan	bhawwan,bhawan
boob	booob,boob
poolside	pooolside,poolside
pillowcase	pillowwcase,pillowcase
bookie	boookie,bookie
committeemen	committeeemen,committeemen
mendeleev	mendeleeev,mendeleev
schillebeeckx	schillebeeeckx,schillebeeckx
beetroot	beeetrooot,beetroot
grabowski	grabowwski,grabowski
snowmobiles	snowwmobiles,snowmobiles
freethinkers	freeethinkers,freethinkers
maat	maaat,maat
timekeeping	timekeeeping,timekeeping
kneecap	kneeecap,kneecap
groovy	grooovy,groovy
weedon	weeedon,weedon
timekeeper	timekeeeper,timekeeper
howden	howwden,howden
greenhorn	greeenhorn,greenhorn
likelihoods	likelihooods,likelihoods
edgewood	edgewoood,edgewood
henslowe	henslowwe,henslowe
homeschooling	homeschoooling,homeschooling
middelburg	midddelburg,middelburg
footfall	foootfall,footfall
bowerman	bowwerman,bowerman
fellowes	fellowwes,fellowes
dawa	dawwa,dawa
bookbinder	boookbinder,bookbinder
awacs	awwacs,awacs
tomorrows	tomorrowws,tomorrows
dawdling	dawwdling,dawdling
drawingroom	drawwingrooom,drawingroom
chickasaws	chickasawws,chickasaws
cedaw	cedaww,cedaw
wardlaw	wardlaww,wardlaw
bawerk	bawwerk,bawerk
laa	laaa,laa
minesweepers	minesweeepers,minesweepers
blakeslee	blakesleee,blakeslee
holyrood	holyroood,holyrood
unlooked	unloooked,unlooked
drowsily	drowwsily,drowsily
droopy	drooopy,droopy
doorframe	dooorframe,doorframe
oon	ooon,oon
woodworkers	wooodworkers,woodworkers
sledding	sleddding,sledding
hawked	hawwked,hawked
zebedee	zebedeee,zebedee
reflow	refloww,reflow
foolscap	fooolscap,foolscap
craw	craww,craw
mallee	malleee,mallee
leesburg	leeesburg,leesburg
howse	howwse,howse
jazeera	jazeeera,jazeera
chainsaw	chainsaww,chainsaw
maddeningly	madddeningly,maddeningly
hallow	halloww,hallow
spooks	spoooks,spooks
owsley	owwsley,owsley
cowden	cowwden,cowden
overstreet	overstreeet,overstreet
poodles	pooodles,poodles
middlesbrough	midddlesbrough,middlesbrough
jawa	jawwa,jawa
aae	aaae,aae
micawber	micawwber,micawber
spotswood	spotswoood,spotswood
roofless	rooofless,roofless
oddball	odddball,oddball
jonestown	jonestowwn,jonestown
foochow	fooochoww,foochow
mortgagees	mortgageees,mortgagees
backroom	backrooom,backroom
eeuw	eeeuww,eeuw
pocketbooks	pocketboooks,pocketbooks
hooligan	hoooligan,hooligan
redbook	redboook,redbook
benteen	benteeen,benteen
electroweak	electrowweak,electroweak
fowling	fowwling,fowling
brownfield	browwnfield,brownfield
seel	seeel,seel
irredeemable	irredeeemable,irredeemable
tureen	tureeen,tureen
hoodlum	hooodlum,hoodlum
lowa	lowwa,lowa
willowy	willowwy,willowy
miyazawa	miyazawwa,miyazawa
kiddush	kidddush,kiddush
lawd	lawwd,lawd
midweek	midweeek,midweek
oost	ooost,oost
goodchild	gooodchild,goodchild
reefer	reeefer,reefer
louw	louww,louw
adda	addda,adda
pamphleteers	pamphleteeers,pamphleteers
powerpc	powwerpc,powerpc
rickshaws	rickshawws,rickshaws
maddock	madddock,maddock
scheele	scheeele,scheele
deedee	deeedeee,deedee
elizabethtown	elizabethtowwn,elizabethtown
greenhalgh	greeenhalgh,greenhalgh
windowpanes	windowwpanes,windowpanes
coordinative	cooordinative,coordinative
nowise	nowwise,nowise
rodd	roddd,rodd
seeckt	seeeckt,seeckt
steeping	steeeping,steeping
kidded	kiddded,kidded
gawking	gawwking,gawking
streetlight	streeetlight,streetlight
twaddle	twadddle,twaddle
isaak	isaaak,isaak
kawaguchi	kawwaguchi,kawaguchi
aav	aaav,aav
doordarshan	dooordarshan,doordarshan
goodhue	gooodhue,goodhue
joos	jooos,joos
knowland	knowwland,knowland
queenly	queeenly,queenly
powerplant	powwerplant,powerplant
racketeer	racketeeer,racketeer
kiddies	kidddies,kiddies
beddoes	bedddoes,beddoes
beek	beeek,beek
betweens	betweeens,betweens
crees	creees,crees
freeholder	freeeholder,freeholder
toothy	tooothy,toothy
showtime	showwtime,showtime
clubfoot	clubfooot,clubfoot
spedding	speddding,spedding
knowe	knowwe,knowe
mdd	mddd,mdd
hiaa	hiaaa,hiaa
needleman	neeedleman,needleman
kathiawar	kathiawwar,kathiawar
sneed	sneeed,sneed
threefourths	threeefourths,threefourths
soonest	sooonest,soonest
joost	jooost,joost
beekeeper	beeekeeeper,beekeeper
crawlers	crawwlers,crawlers
ftaa	ftaaa,ftaa
beehives	beeehives,beehives
merimee	merimeee,merimee
deel	deeel,deel
hoofed	hooofed,hoofed
disproof	disprooof,disproof
hadde	haddde,hadde
powderly	powwderly,powderly
jezreel	jezreeel,jezreel
europeen	europeeen,europeen
haakon	haaakon,haakon
schoolmistress	schooolmistress,schoolmistress
hacksaw	hacksaww,hacksaw
seein	seeein,seein
preexistent	preeexistent,preexistent
rockaway	rockawway,rockaway
seebohm	seeebohm,seebohm
suttee	sutteee,suttee
parakeets	parakeeets,parakeets
geez	geeez,geez
marketeers	marketeeers,marketeers
disallows	disallowws,disallows
aaronson	aaaronson,aaronson
invitees	inviteees,invitees
weekes	weeekes,weekes
grotowski	grotowwski,grotowski
eells	eeells,eells
blowdown	blowwdowwn,blowdown
duree	dureee,duree
rhondda	rhonddda,rhondda
moorhouse	mooorhouse,moorhouse
hawtrey	hawwtrey,hawtrey
downsized	dowwnsized,downsized
ween	weeen,ween
tomahawks	tomahawwks,tomahawks
selfknowledge	selfknowwledge,selfknowledge
holbrooke	holbroooke,holbrooke
fukuzawa	fukuzawwa,fukuzawa
towson	towwson,towson
teems	teeems,teems
footballer	foootballer,footballer
nonpoor	nonpooor,nonpoor
goodwood	gooodwoood,goodwood
kiddo	kidddo,kiddo
factbook	factboook,factbook
ingrown	ingrowwn,ingrown
boothe	booothe,boothe
leered	leeered,leered
raaf	raaaf,raaf
dowding	dowwding,dowding
snoopy	snooopy,snoopy
sowers	sowwers,sowers
crowfoot	crowwfooot,crowfoot
metaanalysis	metaaanalysis,metaanalysis
kagawa	kagawwa,kagawa
heere	heeere,heere
swoops	swooops,swoops
cheeseburger	cheeeseburger,cheeseburger
greely	greeely,greely
saddling	sadddling,saddling
waddle	wadddle,waddle
passbook	passboook,passbook
paratroops	paratrooops,paratroops
skeet	skeeet,skeet
transferees	transfereees,transferees
peed	peeed,peed
scrimshaw	scrimshaww,scrimshaw
noddings	nodddings,noddings
squawked	squawwked,squawked
sneezes	sneeezes,sneezes
threepenny	threeepenny,threepenny
aag	aaag,aag
cheetahs	cheeetahs,cheetahs
godowns	godowwns,godowns
bowley	bowwley,bowley
bootstraps	boootstraps,bootstraps
knockdown	knockdowwn,knockdown
andreev	andreeev,andreev
careerists	careeerists,careerists
crossbreeding	crossbreeeding,crossbreeding
cowpox	cowwpox,cowpox
sickroom	sickrooom,sickroom
wydawnictwo	wydawwnictwo,wydawnictwo
cheetham	cheeetham,cheetham
trooping	troooping,trooping
meddled	medddled,meddled
isee	iseee,isee
bazooka	bazoooka,bazooka
kawabata	kawwabata,kawabata
dawe	dawwe,dawe
gaddi	gadddi,gaddi
mackinaw	mackinaww,mackinaw
boosey	booosey,boosey
bookmakers	boookmakers,bookmakers
tablespoonful	tablespooonful,tablespoonful
hoon	hooon,hoon
mukerjee	mukerjeee,mukerjee
looke	loooke,looke
kingstown	kingstowwn,kingstown
greenbrier	greeenbrier,greenbrier
evacuee	evacueee,evacuee
subfloor	subflooor,subfloor
greenlanders	greeenlanders,greenlanders
fleeces	fleeeces,fleeces
awad	awwad,awad
threescore	threeescore,threescore
shootin	shoootin,shootin
gowned	gowwned,gowned
eddying	edddying,eddying
gawd	gawwd,gawd
thirtythree	thirtythreee,thirtythree
unaddressed	unadddressed,unaddressed
manatees	manateees,manatees
arrestee	arresteee,arrestee
cowes	cowwes,cowes
shopfloor	shopflooor,shopfloor
bookmaker	boookmaker,bookmaker
teed	teeed,teed
prophethood	prophethoood,prophethood
intraarticular	intraaarticular,intraarticular
jamboree	jamboreee,jamboree
grandee	grandeee,grandee
ddi	dddi,ddi
trueblood	truebloood,trueblood
bookes	boookes,bookes
ogee	ogeee,ogee
siddiqui	sidddiqui,siddiqui
musees	museees,musees
woollcott	wooollcott,woollcott
needled	neeedled,needled
skoog	skooog,skoog
songbook	songboook,songbook
reemerge	reeemerge,reemerge
careen	careeen,careen
izaak	izaaak,izaak
enrollee	enrolleee,enrollee
coddled	codddled,coddled
lawe	lawwe,lawe
bookselling	boookselling,bookselling
woollens	wooollens,woollens
suhrawardy	suhrawwardy,suhrawardy
piltdown	piltdowwn,piltdown
yawl	yawwl,yawl
mazdoor	mazdooor,mazdoor
hoopla	hooopla,hoopla
bleecker	bleeecker,bleecker
helpee	helpeee,helpee
lawyering	lawwyering,lawyering
gridded	griddded,gridded
booz	boooz,booz
catherwood	catherwoood,catherwood
eegs	eeegs,eegs
diningroom	diningrooom,diningroom
schoolhouses	schooolhouses,schoolhouses
fallowing	fallowwing,fallowing
southwood	southwoood,southwood
awoken	awwoken,awoken
lawford	lawwford,lawford
raa	raaa,raa
jaar	jaaar,jaar
awn	awwn,awn
skeeter	skeeeter,skeeter
dowex	dowwex,dowex
arakawa	arakawwa,arakawa
elysee	elyseee,elysee
doody	dooody,doody
steeplechase	steeeplechase,steeplechase
businessweek	businessweeek,businessweek
speedboat	speeedboat,speedboat
hooft	hoooft,hooft
rowbotham	rowwbotham,rowbotham
cowhide	cowwhide,cowhide
garwood	garwoood,garwood
duveen	duveeen,duveen
greenham	greeenham,greenham
chickadees	chickadeees,chickadees
dungarees	dungareees,dungarees
kootenay	koootenay,kootenay
northwood	northwoood,northwood
maass	maaass,maass
patentees	patenteees,patentees
inglewood	inglewoood,inglewood
eets	eeets,eets
mittee	mitteee,mittee
showcasing	showwcasing,showcasing
volksraad	volksraaad,volksraad
rawlsian	rawwlsian,rawlsian
sheena	sheeena,sheena
oddi	odddi,oddi
keepe	keeepe,keepe
snooker	snoooker,snooker
jaffee	jaffeee,jaffee
swallowtail	swallowwtail,swallowtail
poof	pooof,poof
epizootic	epizoootic,epizootic
superadded	superaddded,superadded
sunscreens	sunscreeens,sunscreens
ravenswood	ravenswoood,ravenswood
choosy	chooosy,choosy
tweedy	tweeedy,tweedy
clownish	clowwnish,clownish
disempowerment	disempowwerment,disempowerment
minow	minoww,minow
doormat	dooormat,doormat
deepseated	deeepseated,deepseated
tootsie	toootsie,tootsie
hoodwinked	hooodwinked,hoodwinked
packwood	packwoood,packwood
screed	screeed,screed
cashflow	cashfloww,cashflow
shredder	shreddder,shredder
berween	berweeen,berween
oaa	oaaa,oaa
steere	steeere,steere
cooperativeness	coooperativeness,cooperativeness
blowpipe	blowwpipe,blowpipe
toweling	towweling,toweling
nishikawa	nishikawwa,nishikawa
tsee	tseee,tsee
kaw	kaww,kaw
lawnmower	lawwnmowwer,lawnmower
zoomorphic	zooomorphic,zoomorphic
brownmiller	browwnmiller,brownmiller
coddling	codddling,coddling
steersman	steeersman,steersman
bawa	bawwa,bawa
doodling	dooodling,doodling
cowbird	cowwbird,cowbird
bumblebees	bumblebeees,bumblebees
seaworthiness	seawworthiness,seaworthiness
papeete	papeeete,papeete
steelwork	steeelwork,steelwork
ahluwalia	ahluwwalia,ahluwalia
greediness	greeediness,greediness
staatsbibliothek	staaatsbibliothek,staatsbibliothek
thaws	thawws,thaws
bootlegger	boootlegger,bootlegger
cartwheel	cartwheeel,cartwheel
kawashima	kawwashima,kawashima
kuwaitis	kuwwaitis,kuwaitis
virchows	virchowws,virchows
harrows	harrowws,harrows
lowy	lowwy,lowy
twoway	twowway,twoway
teece	teeece,teece
jankowski	jankowwski,jankowski
levittown	levittowwn,levittown
hawser	hawwser,hawser
geeks	geeeks,geeks
stringfellow	stringfelloww,stringfellow
smithereens	smithereeens,smithereens
mees	meees,mees
haart	haaart,haart
beeping	beeeping,beeping
untrodden	untroddden,untrodden
pingree	pingreee,pingree
keeble	keeeble,keeble
maumee	maumeee,maumee
arrowed	arrowwed,arrowed
howbeit	howwbeit,howbeit
beseeched	beseeeched,beseeched
lowliness	lowwliness,lowliness
mccawley	mccawwley,mccawley
lowdown	lowwdowwn,lowdown
tanglewood	tanglewoood,tanglewood
winnowed	winnowwed,winnowed
stockroom	stockrooom,stockroom
eerste	eeerste,eerste
pinewood	pinewoood,pinewood
overawe	overawwe,overawe
geert	geeert,geert
snowstorms	snowwstorms,snowstorms
boddy	bodddy,boddy
parsee	parseee,parsee
farooq	faroooq,farooq
elbowing	elbowwing,elbowing
aab	aaab,aab
tyree	tyreee,tyree
sheepdog	sheeepdog,sheepdog
breezed	breeezed,breezed
feer	feeer,feer
owa	owwa,owa
bradlee	bradleee,bradlee
freethinker	freeethinker,freethinker
counterflow	counterfloww,counterflow
moog	mooog,moog
divorcees	divorceees,divorcees
downstate	dowwnstate,downstate
tooting	toooting,tooting
seealso	seeealso,seealso
eero	eeero,eero
soundproof	soundprooof,soundproof
odder	oddder,odder
feedstuffs	feeedstuffs,feedstuffs
disavowing	disavowwing,disavowing
woogie	wooogie,woogie
goodin	gooodin,goodin
tepees	tepeees,tepees
nanowires	nanowwires,nanowires
sweeny	sweeeny,sweeny
adducing	addducing,adducing
gawk	gawwk,gawk
pawley	pawwley,pawley
doob	dooob,doob
staal	staaal,staal
eeprom	eeeprom,eeprom
sokolow	sokoloww,sokolow
unbeknown	unbeknowwn,unbeknown
goodpasture	gooodpasture,goodpasture
aashto	aaashto,aashto
troubleshooter	troubleshoooter,troubleshooter
liebowitz	liebowwitz,liebowitz
awadh	awwadh,awadh
freewriting	freeewriting,freewriting
guffaw	guffaww,guffaw
ebooks	eboooks,ebooks
screenwriting	screeenwriting,screenwriting
cooch	coooch,cooch
rootlessness	roootlessness,rootlessness
kaaba	kaaaba,kaaba
plowshares	plowwshares,plowshares
ool	oool,ool
cawley	cawwley,cawley
pledgee	pledgeee,pledgee
cowperwood	cowwperwoood,cowperwood
rowohlt	rowwohlt,rowohlt
rasheed	rasheeed,rasheed
showplace	showwplace,showplace
madding	maddding,madding
goshawk	goshawwk,goshawk
hooton	hoooton,hooton
braidwood	braidwoood,braidwood
whistleblower	whistleblowwer,whistleblower
gansevoort	gansevooort,gansevoort
bitterroot	bitterrooot,bitterroot
footballers	foootballers,footballers
aronowitz	aronowwitz,aronowitz
waw	waww,waw
bookmaking	boookmaking,bookmaking
scudding	scuddding,scudding
glidden	gliddden,glidden
heeling	heeeling,heeling
harewood	harewoood,harewood
coddington	codddington,coddington
shedd	sheddd,shedd
snowboarding	snowwboarding,snowboarding
bronowski	bronowwski,bronowski
roosevelts	rooosevelts,roosevelts
coreldraw	coreldraww,coreldraw
mookerjee	moookerjeee,mookerjee
rower	rowwer,rower
teenth	teeenth,teenth
oroonoko	orooonoko,oroonoko
harlowe	harlowwe,harlowe
hoodoo	hooodooo,hoodoo
trincomalee	trincomaleee,trincomalee
hoopes	hooopes,hoopes
breese	breeese,breese
greenlee	greeenleee,greenlee
goossens	gooossens,goossens
stepladder	stepladdder,stepladder
ashdown	ashdowwn,ashdown
townscape	towwnscape,townscape
zoologie	zooologie,zoologie
taddeo	tadddeo,taddeo
snowdrifts	snowwdrifts,snowdrifts
aalborg	aaalborg,aalborg
crossbows	crossbowws,crossbows
coole	cooole,coole
dunaway	dunawway,dunaway
parsees	parseees,parsees
careerist	careeerist,careerist
wooly	woooly,wooly
footwall	foootwall,footwall
coleslaw	coleslaww,coleslaw
reawaken	reawwaken,reawaken
devisee	deviseee,devisee
riddling	ridddling,riddling
slideshow	slideshoww,slideshow
matinees	matineees,matinees
assemblee	assembleee,assemblee
diddle	didddle,diddle
gitlow	gitloww,gitlow
awwa	awwwa,awwa
freebooters	freeeboooters,freebooters
udders	uddders,udders
sharpshooter	sharpshoooter,sharpshooter
greenacre	greeenacre,greenacre
maatschappij	maaatschappij,maatschappij
sprees	spreees,sprees
flowsheet	flowwsheeet,flowsheet
middlebrook	midddlebroook,middlebrook
tarrow	tarroww,tarrow
oooh	ooooh,oooh
greenwillow	greeenwilloww,greenwillow
peeved	peeeved,peeved
snowpack	snowwpack,snowpack
coorg	cooorg,coorg
buffoons	buffooons,buffoons
doorjamb	dooorjamb,doorjamb
kantorowicz	kantorowwicz,kantorowicz
threepence	threeepence,threepence
blackhawk	blackhawwk,blackhawk
gawky	gawwky,gawky
followeth	followweth,followeth
raabe	raaabe,raabe
lowcost	lowwcost,lowcost
retooling	retoooling,retooling
knowledgeably	knowwledgeably,knowledgeably
streetwise	streeetwise,streetwise
hullabaloo	hullabalooo,hullabaloo
bungee	bungeee,bungee
pauw	pauww,pauw
sawada	sawwada,sawada
bowe	bowwe,bowe
voorhis	vooorhis,voorhis
fenugreek	fenugreeek,fenugreek
puppeteers	puppeteeers,puppeteers
zeeb	zeeeb,zeeb
chowk	chowwk,chowk
yellowknife	yellowwknife,yellowknife
bleeder	bleeeder,bleeder
freese	freeese,freese
negligee	negligeee,negligee
macqueen	macqueeen,macqueen
lawgivers	lawwgivers,lawgivers
meera	meeera,meera
ashbee	ashbeee,ashbee
woodcarving	wooodcarving,woodcarving
preempts	preeempts,preempts
maanen	maaanen,maanen
harrassowitz	harrassowwitz,harrassowitz
townland	towwnland,townland
treeline	treeeline,treeline
rowlatt	rowwlatt,rowlatt
towle	towwle,towle
linwood	linwoood,linwood
iooo	ioooo,iooo
monooxygenase	monoooxygenase,monooxygenase
aah	aaah,aah
lampooned	lampoooned,lampooned
overpowers	overpowwers,overpowers
seene	seeene,seene
wheedling	wheeedling,wheedling
mcnamee	mcnameee,mcnamee
raintree	raintreee,raintree
flowmeters	flowwmeters,flowmeters
victimhood	victimhoood,victimhood
reevaluating	reeevaluating,reevaluating
undercooling	undercoooling,undercooling
boorman	booorman,boorman
kraals	kraaals,kraals
nieuw	nieuww,nieuw
toone	tooone,toone
godden	goddden,godden
velveteen	velveteeen,velveteen
caddies	cadddies,caddies
medd	meddd,medd
neediness	neeediness,neediness
saybrook	saybroook,saybrook
sawfly	sawwfly,sawfly
bookworm	boookworm,bookworm
scheel	scheeel,scheel
spooning	spoooning,spooning
weeklong	weeeklong,weeklong
preen	preeen,preen
sawai	sawwai,sawai
unpeeled	unpeeeled,unpeeled
ruddick	rudddick,ruddick
bookchin	boookchin,bookchin
proofed	prooofed,proofed
brownlie	browwnlie,brownlie
lowman	lowwman,lowman
alloway	allowway,alloway
pattee	patteee,pattee
mellowing	mellowwing,mellowing
altoona	altooona,altoona
showmen	showwmen,showmen
noord	nooord,noord
taproot	taprooot,taproot
mcneely	mcneeely,mcneely
smoothie	smooothie,smoothie
massawa	massawwa,massawa
looses	loooses,looses
deemphasized	deeemphasized,deemphasized
chapbooks	chapboooks,chapbooks
khoo	khooo,khoo
eek	eeek,eek
hawkesworth	hawwkesworth,hawkesworth
drawling	drawwling,drawling
lowrey	lowwrey,lowrey
beeped	beeeped,beeped
snooty	snoooty,snooty
feebler	feeebler,feebler
looper	loooper,looper
pulldown	pulldowwn,pulldown
guffawed	guffawwed,guffawed
adriaan	adriaaan,adriaan
doodles	dooodles,doodles
saal	saaal,saal
lawley	lawwley,lawley
wittkower	wittkowwer,wittkower
puddled	pudddled,puddled
deemphasize	deeemphasize,deemphasize
rawness	rawwness,rawness
kamloops	kamlooops,kamloops
fowle	fowwle,fowle
degroot	degrooot,degroot
adderley	addderley,adderley
proudfoot	proudfooot,proudfoot
howson	howwson,howson
yellowfin	yellowwfin,yellowfin
riebeeck	riebeeeck,riebeeck
saddlebag	sadddlebag,saddlebag
smalltown	smalltowwn,smalltown
uwb	uwwb,uwb
foredoomed	foredooomed,foredoomed
lookers	loookers,lookers
wuthnow	wuthnoww,wuthnow
greenberger	greeenberger,greenberger
queerness	queeerness,queerness
coover	cooover,coover
bowra	bowwra,bowra
sawa	sawwa,sawa
crookedly	croookedly,crookedly
haddington	hadddington,haddington
saadia	saaadia,saadia
greenlandic	greeenlandic,greenlandic
sleeman	sleeeman,sleeman
howley	howwley,howley
consignees	consigneees,consignees
bleeker	bleeeker,bleeker
roundwood	roundwoood,roundwood
calderwood	calderwoood,calderwood
soochow	sooochoww,soochow
snowbound	snowwbound,snowbound
guwahati	guwwahati,guwahati
sprawls	sprawwls,sprawls
ballrooms	ballroooms,ballrooms
markdowns	markdowwns,markdowns
heedlessly	heeedlessly,heedlessly
coordinations	cooordinations,coordinations
unfreedom	unfreeedom,unfreedom
dawdle	dawwdle,dawdle
daddies	dadddies,daddies
reemphasized	reeemphasized,reemphasized
weatherproof	weatherprooof,weatherproof
yahoos	yahooos,yahoos
okeechobee	okeeechobeee,okeechobee
staw	staww,staw
watzlawick	watzlawwick,watzlawick
kolakowski	kolakowwski,kolakowski
millbrook	millbroook,millbrook
sacajawea	sacajawwea,sacajawea
koon	kooon,koon
trawls	trawwls,trawls
atlee	atleee,atlee
newsrooms	newsroooms,newsrooms
slowdowns	slowwdowwns,slowdowns
hornbook	hornboook,hornbook
creer	creeer,creer
jaap	jaaap,jaap
irredeemably	irredeeemably,irredeemably
vereeniging	vereeeniging,vereeniging
bleek	bleeek,bleek
mcdowall	mcdowwall,mcdowall
beechey	beeechey,beechey
bobrow	bobroww,bobrow
lebowitz	lebowwitz,lebowitz
cuddy	cudddy,cuddy
disowning	disowwning,disowning
offscreen	offscreeen,offscreen
hoofbeats	hooofbeats,hoofbeats
wilamowitz	wilamowwitz,wilamowitz
baade	baaade,baade
lowden	lowwden,lowden
laager	laaager,laager
eed	eeed,eed
floorboard	flooorboard,floorboard
gowda	gowwda,gowda
storybooks	storyboooks,storybooks
aabb	aaabb,aabb
mentee	menteee,mentee
quiddity	quidddity,quiddity
pinwheel	pinwheeel,pinwheel
fludd	fluddd,fludd
adductors	addductors,adductors
greenschist	greeenschist,greenschist
squeegee	squeeegeee,squeegee
lookups	loookups,lookups
pawl	pawwl,pawl
countee	counteee,countee
luddites	ludddites,luddites
oooooooo	oooooooooooo,oooooooo
cameroonian	camerooonian,cameroonian
bybee	bybeee,bybee
daan	daaan,daan
speedwell	speeedwell,speedwell
inwood	inwoood,inwood
gowing	gowwing,gowing
mowgli	mowwgli,mowgli
lowness	lowwness,lowness
intraarterial	intraaarterial,intraarterial
dhow	dhoww,dhow
downfield	dowwnfield,downfield
sketchbooks	sketchboooks,sketchbooks
giveaways	giveawways,giveaways
saale	saaale,saale
doctorow	doctoroww,doctorow
pooley	poooley,pooley
peoplehood	peoplehoood,peoplehood
mook	moook,mook
keddie	kedddie,keddie
teepee	teeepeee,teepee
wahoo	wahooo,wahoo
outgrowing	outgrowwing,outgrowing
bollywood	bollywoood,bollywood
fdd	fddd,fdd
colebrooke	colebroooke,colebrooke
exmoor	exmooor,exmoor
queerly	queeerly,queerly
garnishee	garnisheee,garnishee
feedlots	feeedlots,feedlots
bawden	bawwden,bawden
woodcutters	wooodcutters,woodcutters
steevens	steeevens,steevens
lebow	leboww,lebow
towpath	towwpath,towpath
mawkish	mawwkish,mawkish
freebsd	freeebsd,freebsd
sraddha	sradddha,sraddha
roon	rooon,roon
treetop	treeetop,treetop
unlikelihood	unlikelihoood,unlikelihood
cariboo	caribooo,cariboo
glowingly	glowwingly,glowingly
paratroop	paratrooop,paratroop
woodlot	wooodlot,woodlot
leese	leeese,leese
heddle	hedddle,heddle
tumbledown	tumbledowwn,tumbledown
downsize	dowwnsize,downsize
tralee	traleee,tralee
marilee	marileee,marilee
greengrocer	greeengrocer,greengrocer
sweetbreads	sweeetbreads,sweetbreads
peening	peeening,peening
freeform	freeeform,freeform
shantytown	shantytowwn,shantytown
oddness	odddness,oddness
leaa	leaaa,leaa
knoop	knooop,knoop
downpours	dowwnpours,downpours
depauw	depauww,depauw
bhoodan	bhooodan,bhoodan
braddon	bradddon,braddon
shantytowns	shantytowwns,shantytowns
weeden	weeeden,weeden
broadsheets	broadsheeets,broadsheets
peeks	peeeks,peeks
freethinking	freeethinking,freethinking
waterwheel	waterwheeel,waterwheel
macaws	macawws,macaws
logwood	logwoood,logwood
coombes	cooombes,coombes
bengalee	bengaleee,bengalee
nightgowns	nightgowwns,nightgowns
keepsakes	keeepsakes,keepsakes
brownstein	browwnstein,brownstein
zook	zoook,zook
woodsmen	wooodsmen,woodsmen
seebeck	seeebeck,seebeck
brainpower	brainpowwer,brainpower
interbreed	interbreeed,interbreed
dershowitz	dershowwitz,dershowitz
lowlevel	lowwlevel,lowlevel
doddridge	dodddridge,doddridge
wallflower	wallflowwer,wallflower
blowup	blowwup,blowup
woozy	wooozy,woozy
payees	payeees,payees
fleeced	fleeeced,fleeced
hurstwood	hurstwoood,hurstwood
lowcountry	lowwcountry,lowcountry
landseer	landseeer,landseer
overthrows	overthrowws,overthrows
crossflow	crossfloww,crossflow
umpteenth	umpteeenth,umpteenth
dombrowski	dombrowwski,dombrowski
nees	neees,nees
usaaf	usaaaf,usaaf
overfeeding	overfeeeding,overfeeding
shallowest	shallowwest,shallowest
mckeever	mckeeever,mckeever
screenshot	screeenshot,screenshot
downwardly	dowwnwardly,downwardly
rowboats	rowwboats,rowboats
sugawara	sugawwara,sugawara
flowerbeds	flowwerbeds,flowerbeds
mccown	mccowwn,mccown
spooling	spoooling,spooling
heeds	heeeds,heeds
cowgill	cowwgill,cowgill
seafoods	seafooods,seafoods
prithee	pritheee,prithee
fraassen	fraaassen,fraassen
usee	useee,usee
deegan	deeegan,deegan
moonbeams	mooonbeams,moonbeams
woolgar	wooolgar,woolgar
vreeland	vreeeland,vreeland
fellowman	fellowwman,fellowman
showbiz	showwbiz,showbiz
watchtowers	watchtowwers,watchtowers
woodcraft	wooodcraft,woodcraft
pillowcases	pillowwcases,pillowcases
barnouw	barnouww,barnouw
tawi	tawwi,tawi
cawing	cawwing,cawing
broadmoor	broadmooor,broadmoor
livingroom	livingrooom,livingroom
woodlots	wooodlots,woodlots
inbetween	inbetweeen,inbetween
jawline	jawwline,jawline
hounslow	hounsloww,hounslow
howth	howwth,howth
rowdies	rowwdies,rowdies
lowth	lowwth,lowth
clooney	cloooney,clooney
staterooms	stateroooms,staterooms
lawrenceville	lawwrenceville,lawrenceville
floodwater	flooodwater,floodwater
gooders	goooders,gooders
esteems	esteeems,esteems
awfulness	awwfulness,awfulness
woodring	wooodring,woodring
powis	powwis,powis
macgowan	macgowwan,macgowan
goree	goreee,goree
nosebleed	nosebleeed,nosebleed
lydda	lyddda,lydda
rawat	rawwat,rawat
invitee	inviteee,invitee
breedlove	breeedlove,breedlove
uncrowded	uncrowwded,uncrowded
kaa	kaaa,kaa
bawd	bawwd,bawd
commandeer	commandeeer,commandeer
waterpower	waterpowwer,waterpower
goold	gooold,goold
studding	studdding,studding
harrowed	harrowwed,harrowed
doormen	dooormen,doormen
goodby	gooodby,goodby
disagreeably	disagreeeably,disagreeably
queequeg	queeequeg,queequeg
billowy	billowwy,billowy
gnaws	gnawws,gnaws
warshaw	warshaww,warshaw
sleepwalker	sleeepwalker,sleepwalker
koos	kooos,koos
aways	awways,aways
lowbrow	lowwbroww,lowbrow
weepy	weeepy,weepy
nosebleeds	nosebleeeds,nosebleeds
yoknapatawpha	yoknapatawwpha,yoknapatawpha
crowninshield	crowwninshield,crowninshield
adducted	addducted,adducted
wenatchee	wenatcheee,wenatchee
mclaws	mclawws,mclaws
escapee	escapeee,escapee
overcooked	overcoooked,overcooked
gowers	gowwers,gowers
steeling	steeeling,steeling
emcee	emceee,emcee
rookeries	roookeries,rookeries
ondaatje	ondaaatje,ondaatje
pelee	peleee,pelee
flowerpot	flowwerpot,flowerpot
frawley	frawwley,frawley
disavows	disavowws,disavows
pillowed	pillowwed,pillowed
coots	cooots,coots
yellowtail	yellowwtail,yellowtail
dafydd	dafyddd,dafydd
quickdraw	quickdraww,quickdraw
boleslaw	boleslaww,boleslaw
satow	satoww,satow
condoleezza	condoleeezza,condoleezza
gree	greee,gree
owerri	owwerri,owerri
additively	addditively,additively
speechwriter	speeechwriter,speechwriter
gowen	gowwen,gowen
expellees	expelleees,expellees
mediterranee	mediterraneee,mediterranee
cookhouse	coookhouse,cookhouse
westergaard	westergaaard,westergaard
toolkits	tooolkits,toolkits
middlebrow	midddlebroww,middlebrow
retook	retoook,retook
meadowlark	meadowwlark,meadowlark
treed	treeed,treed
gees	geees,gees
barbee	barbeee,barbee
guffaws	guffawws,guffaws
fawzi	fawwzi,fawzi
hartlepool	hartlepoool,hartlepool
sambrook	sambroook,sambrook
preempting	preeempting,preempting
macfadden	macfaddden,macfadden
boardrooms	boardroooms,boardrooms
streeten	streeeten,streeten
arrestees	arresteees,arrestees
parmelee	parmeleee,parmelee
kurnool	kurnoool,kurnool
potchefstroom	potchefstrooom,potchefstroom
staates	staaates,staates
booing	boooing,booing
powdering	powwdering,powdering
croon	crooon,croon
aiee	aieee,aiee
lagoonal	lagooonal,lagoonal
fishhook	fishhoook,fishhook
jackdaw	jackdaww,jackdaw
oolite	ooolite,oolite
ovenproof	ovenprooof,ovenproof
pricewaterhousecoopers	pricewaterhousecooopers,pricewaterhousecoopers
eesti	eeesti,eesti
creedal	creeedal,creedal
crestwood	crestwoood,crestwood
woodsworth	wooodsworth,woodsworth
gawaine	gawwaine,gawaine
lawlike	lawwlike,lawlike
stowaway	stowwawway,stowaway
dowie	dowwie,dowie
servanthood	servanthoood,servanthood
addend	adddend,addend
brooked	broooked,brooked
sree	sreee,sree
longbow	longboww,longbow
priesthoods	priesthooods,priesthoods
lown	lowwn,lown
wheedle	wheeedle,wheedle
downplays	dowwnplays,downplays
lovaas	lovaaas,lovaas
ownerships	owwnerships,ownerships
biddulph	bidddulph,biddulph
comparee	compareee,comparee
areawide	areawwide,areawide
daws	dawws,daws
shawna	shawwna,shawna
masood	masoood,masood
steepening	steeepening,steepening
monsoonal	monsooonal,monsoonal
coffeemaker	coffeeemaker,coffeemaker
zoogeography	zooogeography,zoogeography
killeen	killeeen,killeen
peevishly	peeevishly,peevishly
godown	godowwn,godown
eep	eeep,eep
nowlan	nowwlan,nowlan
cawdor	cawwdor,cawdor
farrowing	farrowwing,farrowing
spooler	spoooler,spooler
beeton	beeeton,beeton
hoosiers	hooosiers,hoosiers
badawi	badawwi,badawi
whitlow	whitloww,whitlow
kankakee	kankakeee,kankakee
preemployment	preeemployment,preemployment
shaheen	shaheeen,shaheen
cockatoos	cockatooos,cockatoos
honeymooners	honeymoooners,honeymooners
faw	faww,faw
teel	teeel,teel
scarecrows	scarecrowws,scarecrows
inflowing	inflowwing,inflowing
washrooms	washroooms,washrooms
hawken	hawwken,hawken
roop	rooop,roop
dooryard	doooryard,dooryard
rauwolfia	rauwwolfia,rauwolfia
lowenfeld	lowwenfeld,lowenfeld
sweetman	sweeetman,sweetman
meetin	meeetin,meetin
cahoots	cahooots,cahoots
cartooning	cartoooning,cartooning
tillamook	tillamoook,tillamook
addicting	adddicting,addicting
rajneesh	rajneeesh,rajneesh
drood	droood,drood
unhallowed	unhallowwed,unhallowed
cowpeas	cowwpeas,cowpeas
seeme	seeeme,seeme
neere	neeere,neere
bluegreen	bluegreeen,bluegreen
alauddin	alaudddin,alauddin
feeley	feeeley,feeley
careering	careeering,careering
musketeer	musketeeer,musketeer
snowcapped	snowwcapped,snowcapped
beeman	beeeman,beeman
siddiqi	sidddiqi,siddiqi
mussoorie	mussooorie,mussoorie
teddington	tedddington,teddington
oooooo	ooooooooo,oooooo
sacagawea	sacagawwea,sacagawea
kalgoorlie	kalgooorlie,kalgoorlie
beechwood	beeechwoood,beechwood
reenacting	reeenacting,reenacting
soone	sooone,soone
cartwheels	cartwheeels,cartwheels
awav	awwav,awav
reefed	reeefed,reefed
gidding	giddding,gidding
huw	huww,huw
buddhaghosa	budddhaghosa,buddhaghosa
ballyhoo	ballyhooo,ballyhoo
droops	drooops,droops
snowdrift	snowwdrift,snowdrift
fishbowl	fishbowwl,fishbowl
hiddenness	hidddenness,hiddenness
howto	howwto,howto
iow	ioww,iow
pooch	poooch,pooch
sheeler	sheeeler,sheeler
feely	feeely,feely
aage	aaage,aage
choosers	chooosers,choosers
dhows	dhowws,dhows
kingswood	kingswoood,kingswood
screener	screeener,screener
cheeseman	cheeeseman,cheeseman
betweene	betweeene,betweene
woolfs	wooolfs,woolfs
streeck	streeeck,streeck
cowman	cowwman,cowman
cheroot	cherooot,cheroot
aee	aeee,aee
keepin	keeepin,keepin
footballs	foootballs,footballs
sydow	sydoww,sydow
woolfolk	wooolfolk,woolfolk
lithgow	lithgoww,lithgow
khaddar	khadddar,khaddar
cesspools	cesspoools,cesspools
colebrook	colebroook,colebrook
luddite	ludddite,luddite
cowshed	cowwshed,cowshed
durfee	durfeee,durfee
haack	haaack,haack
saddening	sadddening,saddening
coosa	cooosa,coosa
siddhas	sidddhas,siddhas
careerism	careeerism,careerism
boscawen	boscawwen,boscawen
saarland	saaarland,saarland
glendower	glendowwer,glendower
allpowerful	allpowwerful,allpowerful
beeston	beeeston,beeston
browbeat	browwbeat,browbeat
sixteenths	sixteeenths,sixteenths
estabrook	estabroook,estabrook
bookbinders	boookbinders,bookbinders
mooning	moooning,mooning
veeck	veeeck,veeck
cuddapah	cudddapah,cuddapah
afterschool	afterschoool,afterschool
wheezes	wheeezes,wheezes
caplow	caploww,caplow
bootable	boootable,bootable
