# English 100k Failures - Vowel Patterns
# Cause: aa/ee/oo/aw/ow/uw/dd trigger vowel transforms
# Format: WORD \t ACTUAL \t BUFFER
# Total: 217 (+ 95 both)
#
# WORD: English word typed
# ACTUAL: engine output after space
# BUFFER: Vietnamese transform state before space

been	bên	bên
see	sê	sê
how	hơ	hơ
now	nơ	nơ
own	ơn	ơn
down	dơn	dơn
too	tô	tô
seen	sên	sên
low	lơ	lơ
room	rôm	rôm
town	tơn	tơn
tree	trê	trê
queen	quên	quên
row	rơ	rơ
lee	lê	lê
moon	môn	môn
thee	thê	thê
dawn	dăn	dăn
bow	bơ	bơ
cow	cơ	cơ
deed	đê	đê
noon	nôn	nôn
boom	bôm	bôm
lawn	lăn	lăn
bee	bê	bê
gown	gơn	gơn
hawk	hăk	hăk
boost	bốt	bốt
oo	ô	ô
teen	tên	tên
eec	êc	êc
ee	ê	ê
dow	dơ	dơ
vow	vơ	vơ
eeg	êg	êg
sown	sơn	sơn
dee	dê	dê
sow	sơ	sơ
loom	lôm	lôm
ooo	oo	oo
tow	tơ	tơ
dd	đ	đ
tee	tê	tê
monsoon	mónon	mónon
boon	bôn	bôn
een	ên	ên
dodd	dod	dod
nee	nê	nê
aaa	aa	aa
ddt	đt	đt
canaan	canan	canan
referee	rểee	rểee
woo	uô	uô
chow	chơ	chơ
eel	êl	êl
rowan	rơan	rơan
cowan	cơan	cơan
hee	hê	hê
pow	pơ	pơ
loo	lô	lô
boo	bô	bô
pawn	păn	păn
ow	ơ	ơ
renee	rene	rene
norwood	noỏd	noỏd
pee	pê	pê
cocoon	cocon	cocon
ree	rê	rê
coo	cô	cô
coon	côn	côn
roost	rốt	rốt
mee	mê	mê
beseech	beéch	beéch
uaw	ưa	ưa
mow	mơ	mơ
soo	sô	sô
aan	ân	ân
heen	hên	hên
hoo	hô	hô
kee	kê	kê
rostow	rớt	rớt
doo	dô	dô
moo	mô	mô
ghee	ghê	ghê
caa	câ	câ
iaa	iâ	iâ
ooze	oe	oe
sawn	săn	săn
chee	chê	chê
yee	yê	yê
naa	nâ	nâ
uw	ư	ư
vee	vê	vê
goo	gô	gô
ioo	iô	iô
baa	bâ	bâ
saa	sâ	sâ
dowd	đơ	đơ
roo	rô	rô
aad	âd	âd
dde	đe	đe
swoon	suôn	suôn
maa	mâ	mâ
paa	pâ	pâ
nowak	nơak	nơak
eea	êa	êa
enfeebled	ènebled	ènebled
poo	pô	pô
pensee	péne	péne
aac	âc	âc
yoo	yô	yô
iee	iê	iê
ddc	đc	đc
neem	nêm	nêm
ooh	ôh	ôh
haan	hân	hân
soong	sông	sông
ood	ôd	ôd
ook	ôk	ôk
oop	ôp	ôp
oooo	ooo	ooo
gow	gơ	gơ
eez	e	e
dda	đa	đa
taa	tâ	tâ
aap	âp	âp
chaffee	chafee	chafee
eeo	êo	êo
ddd	dd	dd
haa	hâ	hâ
ddl	đl	đl
mown	mơn	mơn
uwe	ưe	ưe
veen	vên	vên
dowson	dốn	dốn
eee	ee	ee
nawaz	na	na
ooooo	oooo	oooo
noo	nô	nô
goon	gôn	gôn
aat	ât	ât
horwood	hoỏd	hoỏd
trow	trơ	trơ
aal	âl	âl
mowat	mơat	mơat
powwow	powow	powow
boxwood	boõd	boõd
hopwood	hopod	hopod
tdd	tđ	tđ
gaa	gâ	gâ
thurow	thuở	thuở
awt	ăt	ăt
oot	ôt	ôt
refereed	rểeed	rểeed
toon	tôn	tôn
gowan	gơan	gơan
longwood	longod	longod
ddp	đp	đp
aau	âu	âu
aam	âm	âm
owi	ơi	ơi
eet	êt	êt
vdd	vđ	vđ
lowi	lơi	lơi
nonfood	nònod	nònod
meow	meơ	meơ
macaw	măc	măc
oom	ôm	ôm
aai	âi	âi
teem	têm	têm
daa	dâ	dâ
pdd	pđ	pđ
awk	ăk	ăk
veneered	venered	venered
aaaa	aaa	aaa
eaa	eâ	eâ
bdd	bđ	bđ
laa	lâ	lâ
oon	ôn	ôn
aae	âe	âe
lowa	lơa	lơa
oost	ốt	ốt
deedee	đêee	đêee
aav	âv	âv
mdd	mđ	mđ
towson	tốn	tốn
aag	âg	âg
hoon	hôn	hôn
ddi	đi	đi
booz	bo	bo
raa	râ	râ
awn	ăn	ăn
oaa	oâ	oâ
beseeched	beéched	beéched
aab	âb	âb
owa	ơa	ơa
gawk	găk	găk
ool	ôl	ôl
oroonoko	oỏnoko	oỏnoko
awwa	awa	awa
oooh	ooh	ooh
pauw	paư	paư
chowk	chơk	chơk
aah	âh	âh
khoo	khô	khô
eek	êk	êk
howson	hốn	hốn
bowra	bởa	bởa
eed	êd	êd
oooooooo	ooooooo	ooooooo
daan	dân	dân
fdd	fđ	fđ
lown	lơn	lơn
eep	êp	êp
oooooo	ooooo	ooooo
huw	hư	hư
aee	aê	aê
laws	lắ	lắ
towns	tớn	tớn
roots	rốt	rốt
roof	rồ	rồ
beer	bể	bể
keeps	kếp	kếp
rows	rớ	rớ
deer	dể	dể
deeds	đế	đế
beef	bề	bề
boots	bốt	bốt
cows	cớ	cớ
loops	lốp	lốp
owns	ớn	ớn
bees	bế	bế
reef	rề	rề
downs	dớn	dớn
bows	bớ	bớ
vows	vớ	vớ
reefs	rế	rế
moor	mổ	mổ
cheers	chế	chế
looms	lốm	lốm
moors	mố	mố
hawks	hắk	hắk
lawns	lắn	lắn
beers	bế	bế
rees	rế	rế
veneer	vener	vener
voor	vổ	vổ
seer	sể	sể
gowns	gớn	gớn
hoof	hồ	hồ
beets	bết	bết
saws	sắ	sắ
lows	lớ	lớ
hoofs	hố	hố
aas	ấ	ấ
sows	sớ	sớ
referees	rểees	rểees
dodds	đó	đó
pawns	pắn	pắn
loos	lố	lố
mawr	mẳ	mẳ
maas	mas	mấ
tees	tế	tế
leer	lể	lể
dawns	dắn	dắn
cocoons	cocons	cocons
moos	mố	mố
seeps	sếp	sếp
heer	hể	hể
oops	ốp	ốp
aaf	ầ	ầ
dds	đs	đs
ees	ế	ế
monsoons	mónons	mónons
veneers	veners	veners
noor	nổ	nổ
aar	ẩ	ẩ
coons	cốn	cốn
boor	bổ	bổ
aaas	aas	aas
coors	cố	cố
kees	kế	kế
coos	cố	cố
dees	dế	dế
aws	ắ	ắ
boos	bố	bố
queers	quế	quế
veers	vế	vế
oozes	oé	oé
toots	tốt	tốt
hoots	hốt	hốt
pensees	pénes	pénes
loons	lốn	lốn
hows	hớ	hớ
coops	cốp	cốp
neer	nể	nể
tows	tớ	tớ
goof	gồ	gồ
beeps	bếp	bếp
boons	bốn	bốn
oor	ổ	ổ
eer	ể	ể
awacs	ấc	ấc
cowpox	cỗp	cỗp
thaws	thắ	thắ
mees	mế	mế
macaws	mắc	mắc
wallflower	ửàlllowe	ửàlllowe
powis	pới	pới
aways	ấy	ấy
coots	cốt	cốt
daws	dắ	dắ
