# Vietnamese Auto-Restore Failures
# Format: INPUT \t EXPECTED \t ACTUAL
# Total failures: 233
#
# These words were incorrectly restored to English

baaybie	bâybie	baaybie
beeta	bêta	beeta
boobin	bôbin	boobin
buumf	bùum	buumf
bawi	băi	bawi
bawngca	băngca	bawngca
chaonf	chàon	chaonf
chaateau	château	chaateau
cheei	chêi	cheei
cheep	chêp	cheep
cooca	côca	cooca
coocain	côcain	coocain
coola	côla	coola
cootang	côtang	cootang
coote	côte	coote
cueei	cuêi	cueei
cawi	căi	cawi
cawngdan	căngdan	cawngdan
cawngtin	căngtin	cawngtin
cuwnngs	cứnng	cuwnngs
cuungx	cũung	cuungx
cuwuuuuus	cứuuuuu	cuwuuuuus
cuwuuuuuus	cứuuuuuu	cuwuuuuuus
cuwuwar	cửưa	cuwuwar
dains	dáin	dains
deei	dêi	deei
dems	dém	dems
daw	dă	daw
dawi	dăi	dawi
dawy	dăy	dawy
eecu	êcu	eecu
eeh	êh	eeh
eei	êi	eei
eeke	êke	eeke
eekip	êkip	eekip
eening	êning	eening
eepan	êpan	eepan
eeta	êta	eeta
eey	êy	eey
giowiis	giớii	giowiis
gaw	gă	gaw
gawy	găy	gawy
guwuwir	gửưi	guwuwir
hems	hém	hems
hieuf	hièu	hieuf
hiawu	hiău	hiawu
hoomnay	hômnay	hoomnay
hawi	hăi	hawi
huwmm	hưmm	huwmm
huwmmf	hừmm	huwmmf
huwmmmf	hừmmm	huwmmf
hddrung	hđrung	hddrung
hawy	hăy	hawy
iaau	iâu	iaau
iieen	iiên	iieen
iooi	iôi	iooi
iuoon	iuôn	iuoon
iowx	iỡ	iowx
iuwaf	iừa	iuwaf
iowif	iời	iowif
iowij	iợi	iowij
iowns	iớn	iowns
iuwng	iưng	iuwng
iuwu	iưu	iuwu
iuwowng	iương	iuwowng
kamasutra	kamasutra	kkamasutra
katas	katas	kkatas
keepi	kêpi	keepi
khoog	khôg	khoog
khoomg	khômg	khoomg
khoongbel	khôngbel	khoongbel
khoongg	khôngg	khoongg
khoonggg	khônggg	khoongg
khoongggg	khôngggg	khoongg
khoonggggg	khônggggg	khoongg
khoongggggg	khôngggggg	khoongg
khoonghl	khônghl	khoonghl
khoongl	khôngl	khoongl
khoongol	khôngol	khoongol
khoongt	khôngt	khoongt
khoawcij	khoặci	khoawcij
khaw	khă	khaw
kioot	kiôt	kioot
kddrao	kđrao	kddrao
layown	layơn	layown
leenin	lênin	leenin
leeninit	lêninit	leeninit
leevi	lêvi	leevi
loogic	lôgic	loogic
lowiif	lờii	lowiif
lawmls	lắml	lawmls
lawo	lăo	lawo
mayoo	mayô	mayoo
mems	mém	mems
meetan	mêtan	meetan
moobilet	môbilet	moobilet
moomen	mômen	moomen
mootip	môtip	mootip
maw	mă	maw
mawi	măi	mawi
ngaw	ngă	ngaw
nguwowiif	ngườii	nguwowiif
nguwowilf	ngườil	nguwowilf
nguwowlf	ngườl	nguwowlf
nhaw	nhă	nhaw
nhuwg	nhưg	nhuwg
nhuwgx	nhữg	nhuwgx
nhuwgn	nhưgn	nhuwgn
nhuwta	nhưta	nhuwta
nhuwuwngx	nhữưng	nhuwuwngx
nooel	nôel	nooel
naw	nă	naw
nawg	năg	nawg
nawmg	nămg	nawmg
nawo	năo	nawo
nawy	năy	nawy
nuwuwax	nữưa	nuwuwax
ooboa	ôboa	ooboa
ooii	ôii	ooii
ooliu	ôliu	ooliu
oongi	ôngi	oongi
ooti	ôti	ooti
pes	pé	pes
phainr	phảin	phainr
powf	pờ	powf
pecj	pẹc	pecj
powluya	pơluya	powluya
powmu	pơmu	powmu
quaanl	quânl	quaanl
reei	rêi	reei
roocket	rôcket	roocket
rooma	rôma	rooma
rooti	rôti	rooti
rootisseur	rôtisseur	rootisseur
raw	ră	raw
rawi	răi	rawi
rooinf	rồin	rooinf
rowle	rơle	rowle
rownghen	rơnghen	rownghen
saambanh	sâmbanh	saambanh
saampanh	sâmpanh	saampanh
soocola	sôcola	soocola
soopha	sôpha	soopha
soovanh	sôvanh	soovanh
saw	să	saw
sowmi	sơmi	sowmi
sawngta	săngta	sawngta
sawu	său	sawu
suwuwar	sửưa	suwuwar
suwuwax	sữưa	suwuwax
teei	têi	teei
theep	thêp	theep
theeta	thêta	theeta
thooii	thôii	thooii
thooil	thôil	thooil
thooy	thôy	thooy
thaw	thă	thaw
thowlf	thờl	thowlf
thawngggr	thẳnggg	thawnggr
tioo	tiô	tioo
tooii	tôii	tooii
tooil	tôil	tooil
tootem	tôtem	tootem
trieuf	trièu	trieuf
tuoocbin	tuôcbin	tuoocbin
tawcte	tăcte	tawcte
tawngbo	tăngbo	tawngbo
tuwownglf	tườngl	tuwownglf
vaag	vâg	vaag
vaangl	vângl	vaangl
vaayh	vâyh	vaayh
vowiis	vớii	vowiis
vowls	vớl	vowls
vaaynj	vậyn	vaaynj
vaayngj	vậyng	vaayngj
xems	xém	xems
xeuf	xèu	xeuf
xoonat	xônat	xoonat
xuata	xuât	xuata
xaw	xă	xaw
xowcua	xơcua	xowcua
yeeuuu	yêuuu	yeeuuu
yooga	yôga	yooga
aw	ă	aw
ddagn	đagn	ddagn
ddaaul	đâul	ddaaul
ddaayl	đâyl	ddaayl
ddaayyy	đâyyy	ddaayyy
awcquy	ăcquy	awcquy
ddenta	đenta	ddenta
awh	ăh	awh
uwh	ưh	uwh
owhf	ờh	owhf
uwhf	ừh	uwhf
awhhh	ăhhh	awhh
uwhm	ưhm	uwhm
uwhmf	ừhm	uwhmf
ddieu	đieu	ddieu
ddieuf	đièu	ddieuf
ddiii	điii	ddiii
ddiiiiiiiii	điiiiiiiii	ddiiiiiiiii
owiiiiiiiiii	ơiiiiiiiiii	owiiiiiiiiii
ddiieeuf	điiều	ddiieeuf
ddinamit	đinamit	ddinamit
ddinamo	đinamo	ddinamo
ddiop	điop	ddiop
ddiot	điot	ddiot
ddkys	đký	ddkys
uwmm	ưmm	uwmm
owmmf	ờmm	owmmf
uwmmf	ừmm	uwmmf
uwmmmf	ừmmm	uwmmf
uwmmmmf	ừmmmm	uwmmf
awngten	ăngten	awngten
awnten	ănten	awnten
ddooia	đôia	ddooia
ddols	đól	ddols
ddoola	đôla	ddoola
ddracma	đracma	ddracma
ddawi	đăi	ddawi
ddeeks	đếk	ddeeks
ddoolr	đổl	ddoolr
ddoolj	độl	ddoolj
ddawngten	đăngten	ddawngten
ddeplj	đẹpl	ddeplj
ddawuf	đằu	ddawuf
ddeeys	đếy	ddeeys
ddaayls	đấyl	ddaayls
dduwowccj	đượcc	dduwowccj
dduwowclj	đượcl	dduwowclj
dduwowcltj	đượclt	dduwowcltj
dduwowgf	đườg	dduwowgf
dduwowngngf	đườngng	dduwowngngf
